Date,Hour,Nuclear,Gas,Hydro,Wind,Solar,Biofuel,Total
2021-01-01,1,9021,338,4781,161,0,0,14301
2021-01-01,2,9037,245,4363,141,0,0,13786
2021-01-01,3,9027,214,4028,238,0,0,13507
2021-01-01,4,9182,214,3681,428,0,0,13505
2021-01-01,5,9219,213,3172,277,0,0,12881
2021-01-01,6,9220,212,3199,368,0,0,12999
2021-01-01,7,9213,214,3329,586,0,0,13342
2021-01-01,8,9208,214,3570,735,2,0,13729
2021-01-01,9,9215,214,3694,964,21,0,14108
2021-01-01,10,9245,212,3899,1033,36,0,14425
2021-01-01,11,9418,213,3831,1269,55,0,14786
2021-01-01,12,9595,216,3615,1644,72,0,15142
2021-01-01,13,9688,286,3680,1768,67,0,15489
2021-01-01,14,9691,323,3757,1797,50,0,15618
2021-01-01,15,9698,368,4111,1855,31,0,16063
2021-01-01,16,9695,433,4595,1495,13,0,16231
2021-01-01,17,9686,435,4344,1778,1,0,16244
2021-01-01,18,9681,438,4678,1880,0,0,16677
2021-01-01,19,9683,439,4789,1969,0,0,16880
2021-01-01,20,9782,438,5025,1924,0,0,17169
2021-01-01,21,9797,435,4813,1569,0,0,16614
2021-01-01,22,9802,294,4577,1495,0,0,16168
2021-01-01,23,9814,208,4265,1144,0,0,15431
2021-01-01,24,9791,207,3847,865,0,0,14710
2021-01-02,1,9809,209,3877,575,0,0,14470
2021-01-02,2,9810,209,3545,542,0,0,14106
2021-01-02,3,9818,208,3487,441,0,0,13954
2021-01-02,4,9809,207,3950,437,0,0,14403
2021-01-02,5,9822,207,3658,499,0,0,14186
2021-01-02,6,9837,208,3581,712,0,0,14338
2021-01-02,7,9833,208,3427,730,0,0,14198
2021-01-02,8,9833,208,3745,485,1,0,14272
2021-01-02,9,9829,281,4245,426,3,0,14784
2021-01-02,10,9837,326,4273,276,35,0,14747
2021-01-02,11,9853,500,5070,172,64,0,15659
2021-01-02,12,9847,985,5033,103,59,0,16027
2021-01-02,13,9841,1070,4791,104,72,0,15878
2021-01-02,14,9839,1335,4532,114,65,1,15886
2021-01-02,15,9788,1609,4625,88,40,14,16164
2021-01-02,16,9834,1645,4793,50,22,42,16386
2021-01-02,17,9842,1641,5236,42,2,51,16814
2021-01-02,18,9845,1873,5969,86,0,51,17824
2021-01-02,19,9845,1702,5810,75,0,51,17483
2021-01-02,20,9846,1629,5325,112,0,54,16966
2021-01-02,21,9843,1089,5127,154,0,56,16269
2021-01-02,22,9846,804,4784,214,0,56,15704
2021-01-02,23,9843,483,4281,246,0,14,14867
2021-01-02,24,9848,238,3935,300,0,0,14321
2021-01-03,1,9846,199,3431,252,0,0,13728
2021-01-03,2,9853,199,3392,387,0,0,13831
2021-01-03,3,9841,198,3279,511,0,0,13829
2021-01-03,4,9835,204,3214,384,0,0,13637
2021-01-03,5,9838,210,3275,499,0,0,13822
2021-01-03,6,9847,287,3287,484,0,0,13905
2021-01-03,7,9850,573,3287,303,0,0,14013
2021-01-03,8,9851,934,3501,242,2,0,14530
2021-01-03,9,9851,1323,3641,391,4,0,15210
2021-01-03,10,9848,1425,3945,154,7,0,15379
2021-01-03,11,9848,1434,4361,123,16,0,15782
2021-01-03,12,9856,1425,4833,93,23,21,16251
2021-01-03,13,9850,1498,5093,82,27,50,16600
2021-01-03,14,9839,1673,4653,130,37,51,16383
2021-01-03,15,9834,1824,4699,120,39,51,16567
2021-01-03,16,9842,1838,4694,158,19,51,16602
2021-01-03,17,9844,1894,5394,183,2,51,17368
2021-01-03,18,9852,1926,6195,186,0,56,18215
2021-01-03,19,9848,1934,6094,199,0,61,18136
2021-01-03,20,9843,1730,5563,208,0,68,17412
2021-01-03,21,9848,1531,5071,150,0,64,16664
2021-01-03,22,9859,891,4935,145,0,16,15846
2021-01-03,23,9860,466,4436,175,0,0,14937
2021-01-03,24,9869,250,4171,152,0,0,14442
2021-01-04,1,9866,209,3573,169,0,0,13817
2021-01-04,2,9858,357,3455,205,0,0,13875
2021-01-04,3,9852,626,3173,201,0,0,13852
2021-01-04,4,9849,966,3121,189,0,10,14135
2021-01-04,5,9857,1303,3105,240,0,12,14517
2021-01-04,6,9860,1677,3136,197,0,17,14887
2021-01-04,7,9867,1775,3414,346,0,27,15429
2021-01-04,8,9859,1807,4096,297,1,28,16088
2021-01-04,9,9850,2045,4728,340,1,31,16995
2021-01-04,10,9853,2050,4874,344,9,34,17164
2021-01-04,11,9848,1823,5245,388,19,52,17375
2021-01-04,12,9850,1820,5313,365,27,84,17459
2021-01-04,13,9847,1965,5322,339,33,82,17588
2021-01-04,14,9847,2036,5154,312,33,81,17463
2021-01-04,15,9837,2017,5371,361,28,83,17697
2021-01-04,16,9844,1981,5554,441,16,81,17917
2021-01-04,17,9839,2221,6012,479,3,83,18637
2021-01-04,18,9829,2750,6228,471,0,114,19392
2021-01-04,19,9829,2481,6180,456,0,92,19038
2021-01-04,20,9827,1925,5758,527,0,83,18120
2021-01-04,21,9828,1569,5221,632,0,82,17332
2021-01-04,22,9827,1347,4864,702,0,82,16822
2021-01-04,23,9832,931,4851,573,0,45,16232
2021-01-04,24,9886,806,3970,504,0,23,15189
2021-01-05,1,9902,883,3266,213,0,18,14282
2021-01-05,2,9898,1018,3323,248,0,17,14504
2021-01-05,3,9896,1040,3301,170,0,17,14424
2021-01-05,4,9897,1133,3176,139,0,17,14362
2021-01-05,5,9897,1268,3340,104,0,17,14626
2021-01-05,6,9900,1444,3435,73,0,20,14872
2021-01-05,7,9894,1445,3836,80,0,34,15289
2021-01-05,8,9888,1518,4743,82,0,36,16267
2021-01-05,9,9886,1888,5013,75,1,32,16895
2021-01-05,10,9890,1984,5123,63,8,32,17100
2021-01-05,11,9892,2315,4891,33,22,32,17185
2021-01-05,12,9891,2524,4837,27,31,32,17342
2021-01-05,13,9887,2424,4867,45,32,32,17287
2021-01-05,14,9887,2644,4792,57,29,32,17441
2021-01-05,15,9898,2426,5071,73,23,56,17547
2021-01-05,16,9920,2618,5107,75,14,83,17817
2021-01-05,17,9919,2743,5626,91,4,83,18466
2021-01-05,18,9918,3127,5913,103,0,111,19172
2021-01-05,19,9920,2960,5815,102,0,97,18894
2021-01-05,20,9916,2871,5531,90,0,82,18490
2021-01-05,21,9913,2487,5441,77,0,82,18000
2021-01-05,22,9912,2274,4821,90,0,82,17179
2021-01-05,23,9910,1324,4458,132,0,82,15906
2021-01-05,24,9911,923,4176,187,0,75,15272
2021-01-06,1,9912,804,3833,164,0,70,14783
2021-01-06,2,9906,812,3446,101,0,69,14334
2021-01-06,3,9908,891,3422,128,0,68,14417
2021-01-06,4,9915,1190,3221,113,0,70,14509
2021-01-06,5,9912,1505,3220,140,0,90,14867
2021-01-06,6,9903,1662,3425,294,0,105,15389
2021-01-06,7,9910,1675,4087,321,0,119,16112
2021-01-06,8,9914,1692,4945,317,0,125,16993
2021-01-06,9,9911,1833,5215,465,3,123,17550
2021-01-06,10,9908,1963,5164,529,15,111,17690
2021-01-06,11,9912,2362,4825,473,40,107,17719
2021-01-06,12,9903,2569,4587,395,102,104,17660
2021-01-06,13,9898,2605,4432,379,110,99,17523
2021-01-06,14,9747,2400,4513,416,83,104,17263
2021-01-06,15,9839,2077,4846,449,50,112,17373
2021-01-06,16,9909,2177,4838,430,49,110,17513
2021-01-06,17,9909,2227,5395,524,11,107,18173
2021-01-06,18,9910,2870,5937,566,0,117,19400
2021-01-06,19,9912,2659,5760,606,0,109,19046
2021-01-06,20,9911,1927,5719,630,0,96,18283
2021-01-06,21,9911,1953,5261,649,0,89,17863
2021-01-06,22,9906,1414,4967,723,0,87,17097
2021-01-06,23,9901,1007,4399,740,0,42,16089
2021-01-06,24,9898,532,4094,724,0,22,15270
2021-01-07,1,9901,404,3726,656,0,18,14705
2021-01-07,2,9892,478,3706,694,0,17,14787
2021-01-07,3,9885,793,3336,761,0,17,14792
2021-01-07,4,9877,1281,3243,731,0,16,15148
2021-01-07,5,9886,1673,3282,881,0,17,15739
2021-01-07,6,9885,1785,3455,1119,0,42,16286
2021-01-07,7,9886,1768,3923,1017,0,83,16677
2021-01-07,8,9890,1776,4772,1036,2,87,17563
2021-01-07,9,9886,1785,5071,1052,7,102,17903
2021-01-07,10,9879,1829,4990,981,38,108,17825
2021-01-07,11,9882,1836,4996,877,67,105,17763
2021-01-07,12,9890,1965,4884,816,94,105,17754
2021-01-07,13,9888,1935,4767,599,109,98,17396
2021-01-07,14,9885,1892,4585,448,126,99,17035
2021-01-07,15,9887,1777,4553,464,155,103,16939
2021-01-07,16,9886,1952,4470,599,117,100,17124
2021-01-07,17,9886,2020,5211,772,24,98,18011
2021-01-07,18,9884,2451,5992,943,0,104,19374
2021-01-07,19,9880,2281,5830,1059,0,104,19154
2021-01-07,20,9881,1874,5551,1191,0,96,18593
2021-01-07,21,9873,1484,5230,1322,0,87,17996
2021-01-07,22,9874,1170,4907,1364,0,51,17366
2021-01-07,23,9882,1031,4111,1332,0,31,16387
2021-01-07,24,9881,689,3718,1115,0,21,15424
2021-01-08,1,9874,295,3835,1018,0,16,15038
2021-01-08,2,9872,227,4307,938,0,15,15359
2021-01-08,3,9869,310,4082,958,0,17,15236
2021-01-08,4,9871,737,3758,863,0,18,15247
2021-01-08,5,9868,1373,3666,673,0,17,15597
2021-01-08,6,9876,1768,3709,550,0,18,15921
2021-01-08,7,9878,1767,3912,908,0,23,16488
2021-01-08,8,9873,1775,4595,1013,3,31,17290
2021-01-08,9,9869,1969,5253,978,10,32,18111
2021-01-08,10,9863,2340,5186,841,60,31,18321
2021-01-08,11,9862,2139,4845,600,154,31,17631
2021-01-08,12,9861,2142,4836,389,192,31,17451
2021-01-08,13,9857,1978,4744,444,189,31,17243
2021-01-08,14,9713,1944,4484,583,180,31,16935
2021-01-08,15,9824,2057,4317,436,147,31,16812
2021-01-08,16,9870,2318,4362,360,59,53,17022
2021-01-08,17,9871,2338,4786,889,19,83,17986
2021-01-08,18,9873,2394,5836,1046,0,84,19233
2021-01-08,19,9871,2334,5802,1083,0,84,19174
2021-01-08,20,9876,1932,5667,998,0,85,18558
2021-01-08,21,9872,1643,5267,1152,0,71,18005
2021-01-08,22,9875,1178,4766,1174,0,32,17025
2021-01-08,23,9879,849,4231,1183,0,32,16174
2021-01-08,24,9883,514,3913,1206,0,14,15530
2021-01-09,1,9952,238,3546,1151,0,0,14887
2021-01-09,2,10104,200,3437,1074,0,0,14815
2021-01-09,3,10101,202,3581,1007,0,0,14891
2021-01-09,4,10099,210,3469,645,0,0,14423
2021-01-09,5,10099,334,3454,729,0,0,14616
2021-01-09,6,10097,716,3465,800,0,0,15078
2021-01-09,7,10098,995,3589,800,1,0,15483
2021-01-09,8,10100,1266,4120,776,2,0,16264
2021-01-09,9,10114,1256,4575,753,31,0,16729
2021-01-09,10,10113,1263,4103,596,98,0,16173
2021-01-09,11,10106,1401,4099,274,177,0,16057
2021-01-09,12,10063,1398,4336,124,219,0,16140
2021-01-09,13,10063,1399,4251,83,244,0,16040
2021-01-09,14,10063,1417,4214,75,254,0,16023
2021-01-09,15,10062,1183,4438,118,165,0,15966
2021-01-09,16,10060,1163,4620,158,91,0,16092
2021-01-09,17,10061,1288,4747,308,22,0,16426
2021-01-09,18,10001,1807,5476,479,0,0,17763
2021-01-09,19,10156,2070,5323,676,0,0,18225
2021-01-09,20,10269,1131,5450,761,0,0,17611
2021-01-09,21,10268,1002,5214,696,0,0,17180
2021-01-09,22,10273,953,4906,697,0,0,16829
2021-01-09,23,10273,797,4129,655,0,0,15854
2021-01-09,24,10272,797,3559,610,0,0,15238
2021-01-10,1,10271,472,3316,518,0,0,14577
2021-01-10,2,10270,387,3450,395,0,0,14502
2021-01-10,3,10260,389,3477,342,0,0,14468
2021-01-10,4,10259,419,3364,312,0,0,14354
2021-01-10,5,10269,460,3234,172,0,0,14135
2021-01-10,6,10272,570,3258,183,0,0,14283
2021-01-10,7,10270,724,3575,163,0,0,14732
2021-01-10,8,10275,811,4274,167,1,0,15528
2021-01-10,9,10275,830,4323,199,17,0,15644
2021-01-10,10,10264,960,4501,180,53,0,15958
2021-01-10,11,10278,1343,4422,178,111,0,16332
2021-01-10,12,10276,1591,3838,191,160,0,16056
2021-01-10,13,10273,1639,3880,215,205,0,16212
2021-01-10,14,10275,1764,3934,197,228,0,16398
2021-01-10,15,10275,1805,4235,224,149,0,16688
2021-01-10,16,10210,1930,4305,217,78,0,16740
2021-01-10,17,10217,2122,5245,176,15,0,17775
2021-01-10,18,10170,2800,5732,186,0,0,18888
2021-01-10,19,10178,2224,5649,234,0,0,18285
2021-01-10,20,10182,1876,5654,313,0,0,18025
2021-01-10,21,10177,1678,5282,337,0,0,17474
2021-01-10,22,10176,1483,5083,287,0,0,17029
2021-01-10,23,10167,1457,4559,241,0,0,16424
2021-01-10,24,10160,839,4340,241,0,0,15580
2021-01-11,1,10161,469,4096,302,0,5,15033
2021-01-11,2,10163,390,4047,371,0,15,14986
2021-01-11,3,9948,475,3519,414,0,17,14373
2021-01-11,4,9810,689,3333,509,0,17,14358
2021-01-11,5,9813,892,3267,491,0,17,14480
2021-01-11,6,9825,1201,3440,379,0,19,14864
2021-01-11,7,9824,1236,4159,477,0,28,15724
2021-01-11,8,9828,1312,5406,739,2,32,17319
2021-01-11,9,9833,1318,5615,874,7,32,17679
2021-01-11,10,9835,1316,5426,1174,22,32,17805
2021-01-11,11,9822,1414,4866,1568,49,32,17751
2021-01-11,12,9820,1552,4729,1688,54,32,17875
2021-01-11,13,9819,1658,4837,1871,54,32,18271
2021-01-11,14,9817,1521,4966,2132,35,32,18503
2021-01-11,15,9825,1437,4623,2077,22,32,18016
2021-01-11,16,9825,1458,5064,2069,14,34,18464
2021-01-11,17,9826,1464,5492,1995,3,37,18817
2021-01-11,18,9831,1473,5898,2258,0,46,19506
2021-01-11,19,9827,1242,5430,2353,0,39,18891
2021-01-11,20,9826,805,5185,2534,0,39,18389
2021-01-11,21,9824,624,4885,2617,0,37,17987
2021-01-11,22,9824,451,4897,2566,0,32,17770
2021-01-11,23,9814,387,4184,2368,0,32,16785
2021-01-11,24,9826,385,3985,2135,0,25,16356
2021-01-12,1,9832,385,3736,1478,0,18,15449
2021-01-12,2,9849,449,4258,1246,0,16,15818
2021-01-12,3,9856,466,4071,1066,0,16,15475
2021-01-12,4,9849,701,3981,985,0,16,15532
2021-01-12,5,9855,1010,3565,826,0,16,15272
2021-01-12,6,9855,1197,3564,421,0,20,15057
2021-01-12,7,9854,1294,3964,956,0,26,16094
2021-01-12,8,9849,1386,4794,1177,2,32,17240
2021-01-12,9,9848,1562,5612,1212,4,32,18270
2021-01-12,10,9854,1916,5659,1220,15,32,18696
2021-01-12,11,9855,2366,5366,1175,21,32,18815
2021-01-12,12,9860,2449,5067,1387,34,32,18829
2021-01-12,13,9862,2335,5019,1565,37,32,18850
2021-01-12,14,9866,1882,5110,1507,32,31,18428
2021-01-12,15,9877,1859,4793,1389,23,32,17973
2021-01-12,16,9868,2007,5049,1231,14,32,18201
2021-01-12,17,9871,1912,5773,1074,2,32,18664
2021-01-12,18,9872,2410,6164,1010,0,32,19488
2021-01-12,19,9873,2302,6048,907,0,32,19162
2021-01-12,20,9872,1834,5908,862,0,32,18508
2021-01-12,21,9867,1747,5599,770,0,32,18015
2021-01-12,22,9867,1545,4845,850,0,32,17139
2021-01-12,23,9866,1071,4324,993,0,32,16286
2021-01-12,24,9871,346,3823,1158,0,23,15221
2021-01-13,1,9885,203,3641,1081,0,17,14827
2021-01-13,2,9878,207,3670,1247,0,16,15018
2021-01-13,3,9885,216,3680,1348,0,16,15145
2021-01-13,4,9886,395,3588,1346,0,16,15231
2021-01-13,5,9889,655,3543,1105,0,16,15208
2021-01-13,6,9887,852,3559,1266,0,21,15585
2021-01-13,7,9883,1010,3841,2126,0,29,16889
2021-01-13,8,9884,1037,4292,2148,2,32,17395
2021-01-13,9,9885,1040,4468,2443,5,34,17875
2021-01-13,10,9883,1134,4386,2439,16,35,17893
2021-01-13,11,9885,1390,4191,2762,43,34,18305
2021-01-13,12,9883,1403,4095,2470,67,32,17950
2021-01-13,13,9883,1409,4171,2453,84,32,18032
2021-01-13,14,9879,1080,4238,2169,71,32,17469
2021-01-13,15,9883,840,4407,2436,87,33,17686
2021-01-13,16,9900,736,4633,2451,55,33,17808
2021-01-13,17,9910,840,5058,2409,15,32,18264
2021-01-13,18,9939,983,5690,2418,0,32,19062
2021-01-13,19,9999,985,5564,2090,0,32,18670
2021-01-13,20,10008,826,5454,1777,0,32,18097
2021-01-13,21,10007,637,5085,1797,0,32,17558
2021-01-13,22,10001,613,4618,1486,0,32,16750
2021-01-13,23,9999,615,4147,1475,0,32,16268
2021-01-13,24,10005,303,4038,1485,0,22,15853
2021-01-14,1,10003,205,3824,1285,0,19,15336
2021-01-14,2,9994,209,4120,1094,0,17,15434
2021-01-14,3,9992,295,4107,852,0,17,15263
2021-01-14,4,9999,400,4254,622,0,17,15292
2021-01-14,5,9995,722,4187,412,0,17,15333
2021-01-14,6,10014,1159,3713,224,0,20,15130
2021-01-14,7,10019,1221,3809,176,0,29,15254
2021-01-14,8,10017,1274,4630,350,2,37,16310
2021-01-14,9,10016,1372,5121,326,7,39,16881
2021-01-14,10,10020,1405,5053,393,40,33,16944
2021-01-14,11,10015,1430,4686,624,67,37,16859
2021-01-14,12,10012,1606,4603,461,90,32,16804
2021-01-14,13,10015,1609,4734,419,95,32,16904
2021-01-14,14,9904,1737,4550,448,84,32,16755
2021-01-14,15,9998,1770,4464,403,81,32,16748
2021-01-14,16,10185,1830,4269,323,56,33,16696
2021-01-14,17,10197,1924,4745,626,12,32,17536
2021-01-14,18,10191,2042,5424,969,0,32,18658
2021-01-14,19,10199,1998,4919,1266,0,32,18414
2021-01-14,20,10201,1522,4602,1287,0,32,17644
2021-01-14,21,10197,799,4529,1719,0,32,17276
2021-01-14,22,10187,499,4369,2266,0,32,17353
2021-01-14,23,10193,357,3722,2389,0,32,16693
2021-01-14,24,10197,197,3636,2210,0,21,16261
2021-01-15,1,10200,197,3590,1448,0,17,15452
2021-01-15,2,10197,196,3496,1192,0,17,15098
2021-01-15,3,10197,197,3541,1053,0,17,15005
2021-01-15,4,10196,197,3449,1068,0,17,14927
2021-01-15,5,10191,196,3508,1128,0,17,15040
2021-01-15,6,10227,196,3528,1396,0,20,15367
2021-01-15,7,10288,276,3519,2040,1,27,16151
2021-01-15,8,10280,284,3854,2522,2,32,16974
2021-01-15,9,10266,450,4074,2981,17,32,17820
2021-01-15,10,10266,595,4142,2872,49,27,17951
2021-01-15,11,10262,776,4209,3203,70,27,18547
2021-01-15,12,10264,1046,4320,2918,77,27,18652
2021-01-15,13,10284,1212,4338,2722,62,27,18645
2021-01-15,14,10286,1216,4291,2583,56,27,18459
2021-01-15,15,10286,1210,4435,2526,45,27,18529
2021-01-15,16,10287,1207,4673,2262,24,32,18485
2021-01-15,17,10285,1245,5361,1998,7,33,18929
2021-01-15,18,10284,1209,5722,2074,0,32,19321
2021-01-15,19,10288,771,5700,1811,0,32,18602
2021-01-15,20,10335,627,5403,1519,0,32,17916
2021-01-15,21,10295,285,4944,1477,0,33,17034
2021-01-15,22,9811,194,4974,1390,0,32,16401
2021-01-15,23,9685,197,4630,1227,0,32,15771
2021-01-15,24,9694,193,4634,955,0,20,15496
2021-01-16,1,9699,269,4207,956,0,1,15132
2021-01-16,2,9703,237,3899,893,0,0,14732
2021-01-16,3,9692,232,3940,762,0,0,14626
2021-01-16,4,9698,246,3995,588,0,0,14527
2021-01-16,5,9703,491,4340,435,0,0,14969
2021-01-16,6,9707,585,3953,369,0,0,14614
2021-01-16,7,9719,859,3860,263,0,0,14701
2021-01-16,8,9725,1030,3948,126,1,0,14830
2021-01-16,9,9727,1386,4171,137,6,0,15427
2021-01-16,10,9724,1457,4207,50,8,0,15446
2021-01-16,11,9723,1479,4434,133,39,0,15808
2021-01-16,12,9721,1612,4583,244,99,0,16259
2021-01-16,13,9722,1579,4281,478,120,0,16180
2021-01-16,14,9720,1573,4065,608,105,0,16071
2021-01-16,15,9720,1269,4283,701,80,0,16053
2021-01-16,16,9714,1250,4233,776,41,0,16014
2021-01-16,17,9712,1419,4176,879,10,0,16196
2021-01-16,18,9712,1879,4852,1283,0,0,17726
2021-01-16,19,9713,1590,4378,1489,0,0,17170
2021-01-16,20,9709,914,4534,1574,0,0,16731
2021-01-16,21,9713,587,4531,1892,0,0,16723
2021-01-16,22,9726,408,4221,2172,0,0,16527
2021-01-16,23,9766,229,3785,2062,0,0,15842
2021-01-16,24,9774,191,3592,1952,0,0,15509
2021-01-17,1,9781,186,3372,2074,0,0,15413
2021-01-17,2,9776,187,3373,1689,0,0,15025
2021-01-17,3,9777,188,3395,1513,0,0,14873
2021-01-17,4,9780,194,3211,1620,0,0,14805
2021-01-17,5,9779,197,3170,1750,0,0,14896
2021-01-17,6,9780,197,3194,1732,0,0,14903
2021-01-17,7,9780,197,3511,1659,0,0,15147
2021-01-17,8,9784,200,3807,1822,0,0,15613
2021-01-17,9,9781,197,3985,1762,4,0,15729
2021-01-17,10,9781,206,3939,1496,20,0,15442
2021-01-17,11,9779,297,4633,1403,83,0,16195
2021-01-17,12,9774,383,4737,1465,76,0,16435
2021-01-17,13,9776,686,4559,1362,54,0,16437
2021-01-17,14,9778,1095,4430,1152,60,0,16515
2021-01-17,15,9782,1427,4555,961,54,0,16779
2021-01-17,16,9786,1448,4214,862,35,0,16345
2021-01-17,17,9785,1432,4727,758,10,0,16712
2021-01-17,18,9784,1909,5717,627,0,0,18037
2021-01-17,19,9784,1809,5519,555,0,0,17667
2021-01-17,20,9782,1158,5306,513,0,0,16759
2021-01-17,21,9776,1004,5129,468,0,0,16377
2021-01-17,22,9775,1022,5046,376,0,0,16219
2021-01-17,23,9784,508,4314,353,0,0,14959
2021-01-17,24,9788,234,4249,334,0,0,14605
2021-01-18,1,9788,201,4101,356,0,0,14446
2021-01-18,2,9794,202,3654,323,0,12,13985
2021-01-18,3,9789,205,3993,316,0,14,14317
2021-01-18,4,9781,336,3973,282,0,16,14388
2021-01-18,5,9788,442,3927,289,0,18,14464
2021-01-18,6,9790,486,4448,291,0,20,15035
2021-01-18,7,9791,794,4703,343,0,29,15660
2021-01-18,8,9790,1283,5380,343,3,44,16843
2021-01-18,9,9790,1456,5575,426,5,82,17334
2021-01-18,10,9792,1608,5499,436,21,111,17467
2021-01-18,11,9789,1673,5440,529,92,132,17655
2021-01-18,12,9786,1450,4944,700,138,95,17113
2021-01-18,13,9792,1585,4888,763,96,122,17246
2021-01-18,14,9796,1707,5212,751,105,128,17699
2021-01-18,15,9787,1779,4786,600,101,87,17140
2021-01-18,16,9790,1972,4923,590,68,102,17445
2021-01-18,17,9780,2044,5202,642,10,87,17765
2021-01-18,18,9779,2450,5980,723,0,88,19020
2021-01-18,19,9779,2210,5779,886,0,114,18768
2021-01-18,20,9777,2002,5332,992,0,94,18197
2021-01-18,21,9775,1400,5424,1095,0,99,17793
2021-01-18,22,9776,886,5066,1388,0,67,17183
2021-01-18,23,9765,679,4255,1352,0,32,16083
2021-01-18,24,9766,587,3790,1531,0,22,15696
2021-01-19,1,9772,253,3813,1593,0,16,15447
2021-01-19,2,9769,206,3672,1592,0,16,15255
2021-01-19,3,9764,207,3703,1892,0,16,15582
2021-01-19,4,9756,205,3678,1934,0,15,15588
2021-01-19,5,9770,205,3670,1944,0,15,15604
2021-01-19,6,9774,206,3692,1678,0,20,15370
2021-01-19,7,9789,206,3899,2062,0,27,15983
2021-01-19,8,9793,207,4442,2761,2,31,17236
2021-01-19,9,9788,208,4909,2706,7,33,17651
2021-01-19,10,9785,296,4806,2863,28,31,17809
2021-01-19,11,9790,307,4830,2907,66,31,17931
2021-01-19,12,9788,509,4520,2928,84,32,17861
2021-01-19,13,9786,865,4472,3036,161,32,18352
2021-01-19,14,9781,1171,4465,3016,126,31,18590
2021-01-19,15,9780,1277,4436,3090,87,14,18684
2021-01-19,16,9777,1259,4519,2616,71,9,18251
2021-01-19,17,9781,1263,5057,2694,16,10,18821
2021-01-19,18,9788,1262,5632,2758,0,12,19452
2021-01-19,19,9791,1258,5504,2517,0,27,19097
2021-01-19,20,9788,1230,5419,2351,0,32,18820
2021-01-19,21,9788,943,5389,2217,0,32,18369
2021-01-19,22,9786,340,4916,2216,0,32,17290
2021-01-19,23,9764,210,4383,2039,0,32,16428
2021-01-19,24,9766,206,3896,1771,0,22,15661
2021-01-20,1,9767,207,3931,1667,0,16,15588
2021-01-20,2,9759,207,3665,1877,0,16,15524
2021-01-20,3,9745,273,3620,1760,0,15,15413
2021-01-20,4,9786,379,3607,2002,0,15,15789
2021-01-20,5,9889,661,3645,1883,0,16,16094
2021-01-20,6,9897,1044,3657,1494,0,23,16115
2021-01-20,7,9895,1323,4184,1548,1,41,16992
2021-01-20,8,9894,1445,4741,1497,1,74,17652
2021-01-20,9,9893,1568,5275,1374,4,95,18209
2021-01-20,10,9892,2166,5390,928,23,110,18509
2021-01-20,11,9890,2431,5312,845,48,115,18641
2021-01-20,12,9892,1842,4971,1114,126,99,18044
2021-01-20,13,9900,1571,4557,1258,154,99,17539
2021-01-20,14,9897,1634,4514,1465,135,99,17744
2021-01-20,15,9898,1974,4439,1232,109,96,17748
2021-01-20,16,9898,2073,4545,1340,64,93,18013
2021-01-20,17,9899,2082,4834,1926,12,94,18847
2021-01-20,18,9885,2073,5378,2410,0,96,19842
2021-01-20,19,9878,2055,4863,2686,0,88,19570
2021-01-20,20,9879,1399,4640,3106,0,87,19111
2021-01-20,21,9877,966,4464,3210,0,87,18604
2021-01-20,22,9870,501,4421,3610,0,42,18444
2021-01-20,23,9901,245,4259,3399,0,32,17836
2021-01-20,24,9904,201,3728,3018,0,22,16873
2021-01-21,1,9894,205,3607,2651,0,17,16374
2021-01-21,2,9900,203,3591,2413,0,17,16124
2021-01-21,3,9902,203,3652,2158,0,16,15931
2021-01-21,4,9906,203,3637,2033,0,16,15795
2021-01-21,5,9900,203,3633,2201,0,17,15954
2021-01-21,6,9902,202,3688,2599,0,20,16411
2021-01-21,7,9905,202,3825,3280,1,25,17238
2021-01-21,8,9908,202,4385,3639,1,31,18166
2021-01-21,9,9907,192,4463,3864,15,31,18472
2021-01-21,10,9904,189,4494,3946,88,31,18652
2021-01-21,11,9907,192,4189,3823,161,32,18304
2021-01-21,12,9908,212,4104,3883,166,31,18304
2021-01-21,13,9907,330,4142,3716,150,31,18276
2021-01-21,14,9906,521,4187,3675,126,31,18446
2021-01-21,15,9899,595,4194,3780,93,31,18592
2021-01-21,16,9902,600,4473,3674,71,31,18751
2021-01-21,17,9894,605,4768,3327,24,31,18649
2021-01-21,18,9896,606,5609,3365,0,31,19507
2021-01-21,19,9897,606,5334,3608,0,31,19476
2021-01-21,20,9896,604,4979,3573,1,31,19084
2021-01-21,21,9903,305,4935,3364,0,31,18538
2021-01-21,22,9902,201,4417,3058,0,31,17609
2021-01-21,23,9902,196,4012,3175,0,31,17316
2021-01-21,24,9904,191,3718,2763,0,23,16599
2021-01-22,1,9904,179,3554,2389,0,17,16043
2021-01-22,2,9895,178,3542,2076,0,17,15708
2021-01-22,3,9899,179,3553,1780,0,16,15427
2021-01-22,4,9907,190,3607,1780,0,16,15500
2021-01-22,5,9911,264,3628,1756,0,16,15575
2021-01-22,6,9914,317,3607,2461,0,19,16318
2021-01-22,7,9912,466,3717,2432,0,24,16551
2021-01-22,8,9908,594,4596,2560,1,29,17688
2021-01-22,9,9905,574,4636,2953,5,30,18103
2021-01-22,10,9904,619,4694,3108,22,30,18377
2021-01-22,11,9910,677,4866,3005,44,30,18532
2021-01-22,12,9906,852,4632,2932,90,31,18443
2021-01-22,13,9908,1072,4754,2913,157,31,18835
2021-01-22,14,9903,888,4639,2641,94,31,18196
2021-01-22,15,9903,830,4657,2868,45,31,18334
2021-01-22,16,9910,939,4714,2885,30,31,18509
2021-01-22,17,9903,1139,4964,2509,11,30,18556
2021-01-22,18,9892,1219,5367,2932,0,31,19441
2021-01-22,19,9896,1215,5499,2951,0,31,19592
2021-01-22,20,9894,1220,5551,3004,0,31,19700
2021-01-22,21,9891,1222,5025,2636,0,31,18805
2021-01-22,22,9885,684,4598,2768,0,31,17966
2021-01-22,23,9895,541,4072,2567,0,31,17106
2021-01-22,24,9897,296,3626,2711,0,26,16556
2021-01-23,1,9902,213,3304,2479,0,8,15906
2021-01-23,2,9902,216,3311,2522,0,0,15951
2021-01-23,3,9891,216,3466,2584,0,0,16157
2021-01-23,4,9889,214,3346,2471,0,0,15920
2021-01-23,5,9893,222,3397,2321,0,0,15833
2021-01-23,6,9889,225,3504,2131,0,0,15749
2021-01-23,7,9890,256,3740,1936,1,2,15825
2021-01-23,8,9890,350,4615,1748,2,24,16629
2021-01-23,9,9893,433,5052,1714,33,50,17175
2021-01-23,10,9895,903,4957,1551,116,53,17475
2021-01-23,11,9889,1283,5120,1276,209,53,17830
2021-01-23,12,9886,1579,4992,1269,286,53,18065
2021-01-23,13,9884,1745,4517,1427,325,54,17952
2021-01-23,14,9879,1752,4409,1311,337,59,17747
2021-01-23,15,9837,1842,4418,1119,282,54,17552
2021-01-23,16,9879,1833,4807,753,140,54,17466
2021-01-23,17,9877,1826,5240,612,37,54,17646
2021-01-23,18,9877,2319,6255,420,1,59,18931
2021-01-23,19,9878,2769,6140,288,0,113,19188
2021-01-23,20,9883,1968,6033,301,0,58,18243
2021-01-23,21,9885,1743,5562,315,0,51,17556
2021-01-23,22,9879,1317,5731,337,0,51,17315
2021-01-23,23,9884,957,5197,333,0,51,16422
2021-01-23,24,9885,853,4535,338,0,54,15665
2021-01-24,1,9880,652,4081,329,0,9,14951
2021-01-24,2,9883,515,3992,359,0,0,14749
2021-01-24,3,9885,529,3909,398,0,0,14721
2021-01-24,4,9882,708,3529,490,0,0,14609
2021-01-24,5,9883,923,3393,628,0,0,14827
2021-01-24,6,9875,977,3344,535,0,0,14731
2021-01-24,7,9875,1010,3755,259,1,0,14900
2021-01-24,8,9876,1014,4522,458,4,0,15874
2021-01-24,9,9875,1030,4492,762,63,0,16222
2021-01-24,10,9871,1241,4518,691,163,0,16484
2021-01-24,11,9863,1530,4575,1110,233,0,17311
2021-01-24,12,9869,1839,4401,1122,227,1,17459
2021-01-24,13,9869,1933,4438,1064,209,27,17540
2021-01-24,14,9866,1746,4692,776,196,52,17328
2021-01-24,15,9865,1916,4741,740,179,52,17493
2021-01-24,16,9865,2102,4685,669,99,52,17472
2021-01-24,17,9872,2234,4911,908,25,52,18002
2021-01-24,18,9869,2436,6183,833,1,52,19374
2021-01-24,19,9872,2469,6076,761,0,52,19230
2021-01-24,20,9874,2221,5520,786,0,52,18453
2021-01-24,21,9870,2087,5445,688,0,52,18142
2021-01-24,22,9866,1679,5603,604,0,52,17804
2021-01-24,23,9864,1398,4863,633,0,51,16809
2021-01-24,24,9868,1393,3858,637,0,16,15772
2021-01-25,1,9873,1417,3238,634,0,0,15162
2021-01-25,2,9866,1529,3243,559,0,3,15200
2021-01-25,3,9853,1804,3299,444,0,12,15412
2021-01-25,4,9855,2197,3247,327,0,11,15637
2021-01-25,5,9867,2390,3273,186,0,17,15733
2021-01-25,6,9864,2515,3610,395,0,55,16439
2021-01-25,7,9865,2555,3990,348,0,78,16836
2021-01-25,8,9862,3129,5104,299,1,86,18481
2021-01-25,9,9861,3647,5248,219,41,109,19125
2021-01-25,10,9864,3648,5085,243,126,93,19059
2021-01-25,11,9858,3056,5004,194,169,92,18373
2021-01-25,12,9858,3177,4924,271,172,84,18486
2021-01-25,13,9860,3063,5010,218,129,83,18363
2021-01-25,14,9856,3110,4974,218,156,87,18401
2021-01-25,15,9856,3036,4951,244,90,87,18264
2021-01-25,16,9857,3332,5025,187,56,85,18542
2021-01-25,17,9859,3730,5200,354,18,86,19247
2021-01-25,18,9861,3785,5809,564,0,86,20105
2021-01-25,19,9857,3786,5744,698,0,85,20170
2021-01-25,20,9857,3214,5385,795,0,88,19339
2021-01-25,21,9857,2796,4981,949,0,102,18685
2021-01-25,22,9774,1889,4553,1176,0,97,17489
2021-01-25,23,9837,1006,4552,1425,0,48,16868
2021-01-25,24,9849,340,3912,1689,0,23,15813
2021-01-26,1,9851,232,3588,1848,0,16,15535
2021-01-26,2,9846,249,3400,1686,0,16,15197
2021-01-26,3,9842,328,3319,1950,0,18,15457
2021-01-26,4,9843,719,3301,2211,0,18,16092
2021-01-26,5,9852,1374,3328,2239,0,16,16809
2021-01-26,6,9855,1899,3451,1853,0,28,17086
2021-01-26,7,9857,2028,3686,1903,1,70,17545
2021-01-26,8,9856,2157,4086,3004,2,81,19186
2021-01-26,9,9847,2278,4467,2807,34,81,19514
2021-01-26,10,9744,2470,4825,2485,50,80,19654
2021-01-26,11,9694,2596,4605,2147,98,80,19220
2021-01-26,12,9849,2596,4454,1830,69,86,18884
2021-01-26,13,9844,2634,4544,1772,57,92,18943
2021-01-26,14,9757,2424,4724,1537,44,80,18566
2021-01-26,15,9717,2996,4721,1324,35,80,18873
2021-01-26,16,9837,3047,4650,1370,25,80,19009
2021-01-26,17,9855,3321,5125,1306,5,80,19692
2021-01-26,18,9841,3680,5639,1397,0,81,20638
2021-01-26,19,9842,3542,5458,1430,0,81,20353
2021-01-26,20,9855,3181,5045,1569,0,81,19731
2021-01-26,21,9858,2825,5000,1496,0,80,19259
2021-01-26,22,9857,1641,4797,1511,0,80,17886
2021-01-26,23,9859,863,4188,1523,0,80,16513
2021-01-26,24,9860,686,3653,1435,0,74,15708
2021-01-27,1,9810,292,3924,1491,0,73,15590
2021-01-27,2,9752,230,3358,1530,0,73,14943
2021-01-27,3,9858,310,3494,1270,0,85,15017
2021-01-27,4,9858,690,3427,1143,0,74,15192
2021-01-27,5,9858,1182,3445,1186,0,85,15756
2021-01-27,6,9879,1760,3309,1099,0,74,16121
2021-01-27,7,9881,2056,3818,1192,0,81,17028
2021-01-27,8,9880,2058,4519,1415,2,79,17953
2021-01-27,9,9881,2058,4778,1413,9,79,18218
2021-01-27,10,9877,2104,5032,1045,31,78,18167
2021-01-27,11,9876,2567,4935,797,64,79,18318
2021-01-27,12,9871,1992,4925,766,110,79,17743
2021-01-27,13,9883,1974,4688,903,167,79,17694
2021-01-27,14,9881,2201,4423,977,187,78,17747
2021-01-27,15,9889,2309,4303,859,166,78,17604
2021-01-27,16,9896,2497,4274,770,116,78,17631
2021-01-27,17,9898,2514,4938,964,42,78,18434
2021-01-27,18,9896,2697,5839,1030,1,78,19541
2021-01-27,19,9899,2903,5725,1253,0,75,19855
2021-01-27,20,9897,2341,5315,1444,0,71,19068
2021-01-27,21,9897,1645,4976,1477,0,65,18060
2021-01-27,22,9899,1280,5185,1503,0,74,17941
2021-01-27,23,9898,1141,4378,1666,0,67,17150
2021-01-27,24,9894,688,3739,1775,0,60,16156
2021-01-28,1,9899,315,3449,2060,0,59,15782
2021-01-28,2,9902,230,3191,2295,0,59,15677
2021-01-28,3,9896,230,3138,2173,0,64,15501
2021-01-28,4,9878,322,3105,2317,0,66,15688
2021-01-28,5,9895,666,3080,2232,0,66,15939
2021-01-28,6,9900,1151,3230,2356,0,71,16708
2021-01-28,7,10000,1626,3438,2057,1,75,17197
2021-01-28,8,9996,1757,4328,2443,3,78,18605
2021-01-28,9,9999,1873,4335,2781,58,80,19126
2021-01-28,10,9999,1898,4418,2464,162,81,19022
2021-01-28,11,10001,1890,4502,2344,246,78,19061
2021-01-28,12,10000,1622,4383,2585,259,78,18927
2021-01-28,13,9999,1220,4449,2725,256,79,18728
2021-01-28,14,10002,1239,4481,2905,253,79,18959
2021-01-28,15,10002,1463,4440,2737,218,79,18939
2021-01-28,16,9999,1914,4633,2857,112,79,19594
2021-01-28,17,9996,2337,4808,2733,31,79,19984
2021-01-28,18,9991,2725,5859,2540,1,79,21195
2021-01-28,19,9990,2718,5717,2650,0,79,21154
2021-01-28,20,9993,2181,5363,2714,0,79,20330
2021-01-28,21,9993,1540,4470,2827,0,79,18909
2021-01-28,22,9995,1295,4528,2914,0,79,18811
2021-01-28,23,9983,1077,4037,2847,0,79,18023
2021-01-28,24,10005,363,3827,2511,0,69,16775
2021-01-29,1,10014,290,4540,2050,0,63,16957
2021-01-29,2,10010,303,4286,1639,0,63,16301
2021-01-29,3,10001,316,4077,1585,0,62,16041
2021-01-29,4,9995,530,3793,1604,0,62,15984
2021-01-29,5,10007,913,3570,1671,0,66,16227
2021-01-29,6,10009,1429,3410,1779,0,70,16697
2021-01-29,7,10013,1986,4002,2135,0,75,18211
2021-01-29,8,10010,2320,5239,2096,4,79,19748
2021-01-29,9,10017,2926,5490,2037,41,78,20589
2021-01-29,10,10013,3000,5522,1840,135,78,20588
2021-01-29,11,10010,2673,5193,1859,182,78,19995
2021-01-29,12,10009,2554,4550,1842,240,78,19273
2021-01-29,13,10005,2602,4295,1742,228,78,18950
2021-01-29,14,9849,2429,4382,1300,221,79,18260
2021-01-29,15,9849,2304,4384,1804,127,76,18544
2021-01-29,16,10016,2365,4368,1763,74,77,18663
2021-01-29,17,10016,2592,5433,1711,32,79,19863
2021-01-29,18,10013,3240,5858,1532,3,76,20722
2021-01-29,19,10017,3798,5826,1313,0,80,21034
2021-01-29,20,10018,3427,5649,1001,0,79,20174
2021-01-29,21,10017,3675,5695,805,0,79,20271
2021-01-29,22,10011,3440,5412,619,0,79,19561
2021-01-29,23,10011,2430,5154,365,0,79,18039
2021-01-29,24,10019,2520,4517,335,0,65,17456
2021-01-30,1,10012,2073,4472,362,0,50,16969
2021-01-30,2,10004,1668,4259,321,0,14,16266
2021-01-30,3,10003,1482,4263,212,0,0,15960
2021-01-30,4,9999,2077,4082,220,0,0,16378
2021-01-30,5,10004,2357,3915,246,0,0,16522
2021-01-30,6,10009,2771,4142,216,0,0,17138
2021-01-30,7,10014,2897,4488,234,1,0,17634
2021-01-30,8,10019,3218,4766,217,4,0,18224
2021-01-30,9,10017,3324,5044,160,54,0,18599
2021-01-30,10,10015,3323,5087,126,132,0,18683
2021-01-30,11,10020,3231,5079,90,190,0,18610
2021-01-30,12,10015,3064,4971,146,234,0,18430
2021-01-30,13,10010,3017,4539,273,277,0,18116
2021-01-30,14,10013,2878,4499,295,274,0,17959
2021-01-30,15,10013,3066,4622,226,295,0,18222
2021-01-30,16,10013,2847,4802,260,224,0,18146
2021-01-30,17,10015,2817,5377,343,75,0,18627
2021-01-30,18,10027,3537,5935,463,2,0,19964
2021-01-30,19,10028,3981,5812,669,0,0,20490
2021-01-30,20,10025,3284,5508,932,0,0,19749
2021-01-30,21,10017,2739,5578,1227,0,0,19561
2021-01-30,22,10021,2390,4907,1478,0,0,18796
2021-01-30,23,10018,1404,4328,1585,0,0,17335
2021-01-30,24,10013,916,3974,1821,0,0,16724
2021-01-31,1,10019,544,3408,1682,0,0,15653
2021-01-31,2,10020,349,3295,1950,0,0,15614
2021-01-31,3,10020,262,3272,2021,0,0,15575
2021-01-31,4,10019,268,3261,2087,0,0,15635
2021-01-31,5,10022,313,3382,2203,0,0,15920
2021-01-31,6,10015,479,3231,2717,0,0,16442
2021-01-31,7,10015,557,3482,2911,0,0,16965
2021-01-31,8,10010,595,3944,3263,5,0,17817
2021-01-31,9,10015,984,4236,3177,61,0,18473
2021-01-31,10,10007,1317,4128,3025,169,3,18649
2021-01-31,11,9998,1548,4036,2884,229,0,18695
2021-01-31,12,9991,1665,3599,2759,247,0,18261
2021-01-31,13,9992,1511,3631,2716,261,0,18111
2021-01-31,14,9986,1505,3584,2672,246,0,17993
2021-01-31,15,9983,1518,3603,2923,211,0,18238
2021-01-31,16,9955,1626,3685,2790,136,0,18192
2021-01-31,17,9968,1881,4342,2980,47,0,19218
2021-01-31,18,9995,1787,5798,3352,4,0,20936
2021-01-31,19,9998,1880,5523,3535,0,0,20936
2021-01-31,20,9996,1862,5635,3437,0,0,20930
2021-01-31,21,9994,1887,5394,3375,0,0,20650
2021-01-31,22,9988,1626,4788,3341,0,0,19743
2021-01-31,23,9997,1015,3957,3280,0,0,18249
2021-01-31,24,9997,535,3849,3218,0,0,17599
2021-02-01,1,9995,555,3707,3206,0,0,17463
2021-02-01,2,9989,693,3454,3133,0,0,17269
2021-02-01,3,10000,839,3334,3046,0,5,17224
2021-02-01,4,9997,1421,3224,2593,0,12,17247
2021-02-01,5,9998,1937,3199,2400,0,11,17545
2021-02-01,6,10005,2298,3469,2582,0,16,18370
2021-02-01,7,10009,2683,4481,2638,1,27,19839
2021-02-01,8,10006,3472,5157,2668,3,28,21334
2021-02-01,9,9996,3852,5283,2441,30,29,21631
2021-02-01,10,9990,4387,5042,2045,92,30,21586
2021-02-01,11,10001,3926,4866,1759,179,30,20761
2021-02-01,12,10009,3311,4755,1645,254,30,20004
2021-02-01,13,10014,2902,4541,1640,256,30,19383
2021-02-01,14,10011,2804,4331,1660,254,30,19090
2021-02-01,15,10009,2608,4164,1926,206,28,18941
2021-02-01,16,10002,2561,4197,2193,134,2,19089
2021-02-01,17,9996,2533,4928,2339,42,0,19838
2021-02-01,18,9984,2875,5860,2307,0,0,21026
2021-02-01,19,9989,2785,5665,2377,0,0,20816
2021-02-01,20,9989,2499,5428,2552,0,0,20468
2021-02-01,21,9988,2117,5338,2362,0,9,19814
2021-02-01,22,9991,1712,5026,2175,0,23,18927
2021-02-01,23,9987,1177,4720,2010,0,26,17920
2021-02-01,24,9979,893,4150,1792,0,16,16830
2021-02-02,1,9985,348,3881,1814,0,11,16039
2021-02-02,2,9987,283,3599,1945,0,14,15828
2021-02-02,3,10005,388,3432,1896,0,16,15737
2021-02-02,4,10000,721,3367,1884,0,17,15989
2021-02-02,5,9995,1307,3391,1732,0,17,16442
2021-02-02,6,9996,1546,3368,1933,0,22,16865
2021-02-02,7,10001,1842,3692,1685,1,30,17251
2021-02-02,8,10003,1896,4311,2770,3,32,19015
2021-02-02,9,9995,1911,4478,2805,50,32,19271
2021-02-02,10,9992,1946,4503,2570,145,32,19188
2021-02-02,11,9985,1313,4580,2325,191,32,18426
2021-02-02,12,9977,1349,4390,2424,196,31,18367
2021-02-02,13,9993,1457,4203,2749,193,31,18626
2021-02-02,14,9994,1579,4081,2679,198,29,18560
2021-02-02,15,9998,1396,4063,2524,195,25,18201
2021-02-02,16,10011,1318,4183,2818,118,21,18469
2021-02-02,17,10016,1223,4239,3196,49,22,18745
2021-02-02,18,10004,1044,4963,3854,4,30,19899
2021-02-02,19,10008,1018,4973,4060,0,32,20091
2021-02-02,20,9843,1022,5010,4135,0,32,20042
2021-02-02,21,9921,604,4675,4103,0,32,19335
2021-02-02,22,9987,272,4203,4082,0,32,18576
2021-02-02,23,9993,291,3973,3921,0,32,18210
2021-02-02,24,9993,256,3517,3324,0,22,17112
2021-02-03,1,9829,227,3440,3340,0,17,16853
2021-02-03,2,9922,228,3411,3161,0,17,16739
2021-02-03,3,9990,225,3230,3229,0,18,16692
2021-02-03,4,9981,224,3303,3385,0,18,16911
2021-02-03,5,9992,226,3230,3466,0,18,16932
2021-02-03,6,9993,231,3337,3109,0,22,16692
2021-02-03,7,9989,260,3710,3304,1,29,17293
2021-02-03,8,9992,332,4725,3502,2,35,18588
2021-02-03,9,9989,347,5076,3177,48,34,18671
2021-02-03,10,9989,555,5152,2682,179,38,18595
2021-02-03,11,9986,767,4964,2278,277,43,18315
2021-02-03,12,9992,1136,4547,2040,366,45,18126
2021-02-03,13,9991,1361,4415,1871,382,48,18068
2021-02-03,14,9987,1458,3881,1789,376,47,17538
2021-02-03,15,9995,1691,3773,1415,361,38,17273
2021-02-03,16,9997,1750,4012,1220,279,34,17292
2021-02-03,17,9988,1881,4497,1110,126,27,17629
2021-02-03,18,9984,1886,5505,1545,12,28,18960
2021-02-03,19,9986,2042,5892,1649,0,31,19600
2021-02-03,20,9992,1666,5505,1727,0,34,18924
2021-02-03,21,9991,1294,5211,1636,0,34,18166
2021-02-03,22,9983,941,5068,1448,0,32,17472
2021-02-03,23,9986,512,4794,1295,0,32,16619
2021-02-03,24,9982,468,4474,1108,0,26,16058
2021-02-04,1,9980,470,4010,1006,0,17,15483
2021-02-04,2,9984,476,3589,950,0,17,15016
2021-02-04,3,9984,496,3541,782,0,17,14820
2021-02-04,4,9981,600,3575,661,0,16,14833
2021-02-04,5,9981,999,3557,574,0,17,15128
2021-02-04,6,9981,1545,3763,514,0,20,15823
2021-02-04,7,9989,1710,4516,508,2,26,16751
2021-02-04,8,9990,1745,5483,700,9,31,17958
2021-02-04,9,9990,2167,5669,913,108,31,18878
2021-02-04,10,9991,1745,5068,1240,220,31,18295
2021-02-04,11,9990,1698,4544,1212,298,31,17773
2021-02-04,12,9985,1574,4451,1256,322,32,17620
2021-02-04,13,9984,1517,4499,1235,338,32,17605
2021-02-04,14,9984,1581,4203,1314,326,32,17440
2021-02-04,15,9987,1462,3923,1440,314,32,17158
2021-02-04,16,9986,1444,4192,1705,204,31,17562
2021-02-04,17,9987,1686,4358,1860,65,31,17987
2021-02-04,18,9991,1644,5302,2434,3,31,19405
2021-02-04,19,9986,1645,5039,2799,0,32,19501
2021-02-04,20,9985,1282,4470,3202,0,32,18971
2021-02-04,21,9985,865,4354,3062,0,32,18298
2021-02-04,22,10025,785,3894,3400,0,32,18136
2021-02-04,23,9617,384,3921,3719,0,32,17673
2021-02-04,24,9176,270,3670,3522,0,27,16665
2021-02-05,1,9172,271,3457,3668,0,18,16586
2021-02-05,2,9163,270,3516,3555,0,17,16521
2021-02-05,3,9159,271,3411,3635,0,16,16492
2021-02-05,4,9168,276,3380,3666,0,16,16506
2021-02-05,5,9165,277,3407,3571,0,17,16437
2021-02-05,6,9169,305,3476,3773,0,20,16743
2021-02-05,7,9171,334,3848,3613,0,26,16992
2021-02-05,8,9177,457,4574,3961,1,31,18201
2021-02-05,9,9175,540,4729,4084,4,31,18563
2021-02-05,10,9174,561,4582,4189,17,31,18554
2021-02-05,11,9101,572,4793,4203,25,31,18725
2021-02-05,12,9108,470,4781,4227,44,32,18662
2021-02-05,13,9153,495,4367,4202,45,31,18293
2021-02-05,14,9184,714,4290,4135,41,31,18395
2021-02-05,15,9201,1009,4162,4050,41,31,18494
2021-02-05,16,9197,1005,4510,4101,34,25,18872
2021-02-05,17,9199,1004,4751,3956,11,26,18947
2021-02-05,18,9204,1010,5284,3984,2,26,19510
2021-02-05,19,9204,1009,5522,4058,0,26,19819
2021-02-05,20,9207,1011,5460,4074,0,27,19779
2021-02-05,21,9199,588,4804,4095,0,27,18713
2021-02-05,22,9197,355,4314,4168,0,26,18060
2021-02-05,23,9208,269,4099,3819,0,26,17421
2021-02-05,24,9207,267,3818,3707,0,15,17014
2021-02-06,1,9202,266,3691,3576,0,2,16737
2021-02-06,2,9191,268,3738,3595,0,0,16792
2021-02-06,3,9184,268,3705,3585,0,0,16742
2021-02-06,4,9185,267,3680,3543,0,0,16675
2021-02-06,5,9193,267,3670,3667,0,0,16797
2021-02-06,6,9196,266,3803,3879,0,0,17144
2021-02-06,7,9194,267,4018,3709,1,0,17189
2021-02-06,8,9192,273,4224,3816,3,0,17508
2021-02-06,9,9190,274,4340,4045,13,0,17862
2021-02-06,10,9188,312,4374,4071,49,0,17994
2021-02-06,11,9185,341,4239,4093,138,0,17996
2021-02-06,12,9188,511,4073,4132,124,0,18028
2021-02-06,13,9187,772,4184,4099,129,0,18371
2021-02-06,14,9100,996,4085,4217,136,0,18534
2021-02-06,15,9137,1193,4122,3814,138,0,18404
2021-02-06,16,9183,1517,4213,3300,97,0,18310
2021-02-06,17,9182,1519,4707,3100,37,0,18545
2021-02-06,18,9185,1509,5347,2984,2,0,19027
2021-02-06,19,9192,1506,5589,3033,0,0,19320
2021-02-06,20,9191,1507,5101,2868,0,0,18667
2021-02-06,21,9187,1501,4752,2438,0,0,17878
2021-02-06,22,9180,585,5151,1893,0,0,16809
2021-02-06,23,9178,314,5112,1784,0,0,16388
2021-02-06,24,9183,273,4444,1636,0,0,15536
2021-02-07,1,9180,269,4243,1427,0,0,15119
2021-02-07,2,9180,268,4273,1303,0,0,15024
2021-02-07,3,9178,270,4248,1115,0,0,14811
2021-02-07,4,9182,269,3987,1192,0,0,14630
2021-02-07,5,9182,269,3648,1441,0,0,14540
2021-02-07,6,9180,268,3687,1692,0,0,14827
2021-02-07,7,9181,272,3885,2037,1,0,15376
2021-02-07,8,9168,272,4240,2399,2,0,16081
2021-02-07,9,9171,360,4947,2319,9,0,16806
2021-02-07,10,9174,370,4625,2651,52,0,16872
2021-02-07,11,9173,536,4486,2751,120,0,17066
2021-02-07,12,9173,661,4374,2704,184,0,17096
2021-02-07,13,9169,832,4646,2720,213,0,17580
2021-02-07,14,9167,1066,4281,2682,274,0,17470
2021-02-07,15,9123,1372,4286,2084,245,0,17110
2021-02-07,16,9162,1487,4494,1875,176,0,17194
2021-02-07,17,9162,1483,5011,2191,93,5,17945
2021-02-07,18,9157,1948,6084,2081,10,5,19285
2021-02-07,19,9161,2291,6110,1899,0,4,19465
2021-02-07,20,9159,2015,5903,1983,0,4,19064
2021-02-07,21,9157,1717,5209,2203,0,4,18290
2021-02-07,22,9154,1169,4959,2277,0,1,17560
2021-02-07,23,9154,1085,4202,2208,0,0,16649
2021-02-07,24,9150,1096,3797,2135,0,0,16178
2021-02-08,1,9151,1177,3836,1882,0,0,16046
2021-02-08,2,9159,1300,4094,1561,0,2,16116
2021-02-08,3,9148,1458,3683,1384,0,9,15682
2021-02-08,4,9143,1645,3707,1169,0,10,15674
2021-02-08,5,9144,1956,4239,758,0,10,16107
2021-02-08,6,9142,2630,4473,703,0,13,16961
2021-02-08,7,9147,3147,5254,638,3,20,18209
2021-02-08,8,9145,3787,5886,536,7,25,19386
2021-02-08,9,9138,4124,5801,585,50,26,19724
2021-02-08,10,9136,4444,5479,611,164,26,19860
2021-02-08,11,9141,4053,4865,620,235,26,18940
2021-02-08,12,9140,3809,4767,585,283,26,18610
2021-02-08,13,9140,3569,4675,485,309,26,18204
2021-02-08,14,9136,3406,4831,413,268,26,18080
2021-02-08,15,9134,3801,4800,360,178,26,18299
2021-02-08,16,9133,3676,5186,322,148,31,18496
2021-02-08,17,9126,4289,5565,309,71,56,19416
2021-02-08,18,9134,4975,6084,243,5,80,20521
2021-02-08,19,9136,5269,5977,274,0,80,20736
2021-02-08,20,9134,4644,5972,378,0,77,20205
2021-02-08,21,9134,4200,5894,359,0,77,19664
2021-02-08,22,9127,3723,5450,349,0,56,18705
2021-02-08,23,9119,3365,4728,365,0,26,17603
2021-02-08,24,9126,2979,4638,329,0,16,17088
2021-02-09,1,9108,2495,4666,294,0,18,16581
2021-02-09,2,9101,2219,4587,265,0,15,16187
2021-02-09,3,9117,2052,4289,269,0,11,15738
2021-02-09,4,9119,2263,4345,259,0,12,15998
2021-02-09,5,9119,2630,4017,256,0,12,16034
2021-02-09,6,9119,2888,4112,288,0,14,16421
2021-02-09,7,9121,3673,5019,317,0,22,18152
2021-02-09,8,9115,4695,5490,375,1,27,19703
2021-02-09,9,9111,4736,5627,411,7,27,19919
2021-02-09,10,9110,4500,5411,488,23,27,19559
2021-02-09,11,9108,4752,4980,480,58,32,19410
2021-02-09,12,9109,4524,4606,575,123,62,18999
2021-02-09,13,9109,4177,4604,474,218,85,18667
2021-02-09,14,9107,3832,4605,386,265,85,18280
2021-02-09,15,9115,4038,4498,381,278,85,18395
2021-02-09,16,9117,3823,5086,406,219,78,18729
2021-02-09,17,9115,3903,5536,351,90,78,19073
2021-02-09,18,9118,4821,6014,311,11,84,20359
2021-02-09,19,9123,5129,6007,497,0,85,20841
2021-02-09,20,9123,4446,5618,918,0,79,20184
2021-02-09,21,9116,3355,5585,1305,0,79,19440
2021-02-09,22,9114,2918,4745,1552,0,43,18372
2021-02-09,23,9107,2507,4161,1436,0,31,17242
2021-02-09,24,9115,2124,4197,1343,0,24,16803
2021-02-10,1,9121,2044,3830,1467,0,20,16482
2021-02-10,2,9117,2061,3616,1256,0,18,16068
2021-02-10,3,9108,2156,3771,1410,0,28,16473
2021-02-10,4,9110,2394,3780,1270,0,60,16614
2021-02-10,5,9112,2740,3716,1089,0,70,16727
2021-02-10,6,9109,2847,3801,810,0,75,16642
2021-02-10,7,9110,2868,4651,727,2,98,17456
2021-02-10,8,9110,3321,5360,748,6,102,18647
2021-02-10,9,9110,3869,5306,753,57,83,19178
2021-02-10,10,9105,3692,5016,526,133,83,18555
2021-02-10,11,9105,4169,4828,368,231,81,18782
2021-02-10,12,9110,4317,4593,338,280,81,18719
2021-02-10,13,9103,4109,4462,323,312,80,18389
2021-02-10,14,9101,3461,4488,351,310,83,17794
2021-02-10,15,9106,3061,4541,415,247,83,17453
2021-02-10,16,9098,3084,5108,277,152,83,17802
2021-02-10,17,9099,3819,5633,160,63,83,18857
2021-02-10,18,9103,4476,6103,91,6,83,19862
2021-02-10,19,9104,4975,6045,99,0,83,20306
2021-02-10,20,9102,4458,6009,134,0,82,19785
2021-02-10,21,9097,4424,5811,146,0,84,19562
2021-02-10,22,9099,4506,4960,186,0,48,18799
2021-02-10,23,9090,3447,4413,264,0,31,17245
2021-02-10,24,9085,2682,4251,287,0,20,16325
2021-02-11,1,9083,2340,4014,299,0,18,15754
2021-02-11,2,9085,2305,3574,431,0,19,15414
2021-02-11,3,9078,2314,3551,360,0,13,15316
2021-02-11,4,9074,2493,3521,578,0,13,15679
2021-02-11,5,9081,2619,3576,417,0,14,15707
2021-02-11,6,9080,2630,3679,609,0,18,16016
2021-02-11,7,9080,2643,4187,1046,2,27,16985
2021-02-11,8,9079,3024,5292,1219,3,46,18663
2021-02-11,9,9076,3076,5271,1175,64,78,18740
2021-02-11,10,9078,2934,5262,821,156,87,18338
2021-02-11,11,9073,3204,4958,467,278,102,18082
2021-02-11,12,9073,3252,4743,288,326,89,17771
2021-02-11,13,9075,3016,4552,252,333,95,17323
2021-02-11,14,9073,3101,4474,257,324,97,17326
2021-02-11,15,9070,2995,4502,244,344,99,17254
2021-02-11,16,9072,3010,4615,264,281,84,17326
2021-02-11,17,9069,3245,5191,348,144,83,18080
2021-02-11,18,9070,4235,5792,428,13,83,19621
2021-02-11,19,9074,4429,5878,635,0,83,20099
2021-02-11,20,9072,3832,5527,993,0,82,19506
2021-02-11,21,9089,3402,5390,1279,0,108,19268
2021-02-11,22,9071,3023,4792,1439,0,81,18406
2021-02-11,23,9056,2364,4527,1420,0,39,17406
2021-02-11,24,9083,2017,3894,1525,0,21,16540
2021-02-12,1,9090,1899,3724,1838,0,19,16570
2021-02-12,2,9087,1871,3576,1224,0,19,15777
2021-02-12,3,9083,1876,3590,1431,0,17,15997
2021-02-12,4,9084,1886,3524,1220,0,15,15729
2021-02-12,5,9087,2196,3746,1263,0,15,16307
2021-02-12,6,9082,2665,4083,1305,0,25,17160
2021-02-12,7,9082,3004,5239,1191,2,63,18581
2021-02-12,8,9084,4038,5600,1313,4,110,20149
2021-02-12,9,9080,4184,5679,1253,49,161,20406
2021-02-12,10,9081,4253,5505,1162,106,159,20266
2021-02-12,11,9086,4074,5431,891,193,167,19842
2021-02-12,12,9087,3961,5174,720,215,172,19329
2021-02-12,13,9088,3738,4837,642,322,172,18799
2021-02-12,14,9083,3569,4736,526,335,169,18418
2021-02-12,15,9079,3504,4699,515,350,172,18319
2021-02-12,16,9082,3643,4932,412,224,168,18461
2021-02-12,17,8977,4392,5410,397,96,171,19443
2021-02-12,18,8822,4971,5984,465,12,199,20453
2021-02-12,19,8834,4924,5919,687,0,192,20556
2021-02-12,20,8845,4659,5836,799,0,175,20314
2021-02-12,21,8844,4341,5450,844,0,175,19654
2021-02-12,22,8848,4112,5068,981,0,146,19155
2021-02-12,23,8840,3298,4631,1027,0,83,17879
2021-02-12,24,8840,2781,4508,1042,0,67,17238
2021-02-13,1,8842,2630,4416,1251,0,51,17190
2021-02-13,2,8841,2282,4183,1324,0,51,16681
2021-02-13,3,8854,2286,4222,1372,0,51,16785
2021-02-13,4,8855,1823,3973,1426,0,51,16128
2021-02-13,5,8855,1790,4002,1448,0,51,16146
2021-02-13,6,8853,2374,4243,1447,0,51,16968
2021-02-13,7,8853,2979,4364,1437,2,51,17686
2021-02-13,8,8853,3241,4760,1575,7,51,18487
2021-02-13,9,8852,3525,5141,1579,46,51,19194
2021-02-13,10,8853,3679,5276,1567,105,49,19529
2021-02-13,11,8848,3980,5033,1582,165,50,19658
2021-02-13,12,8908,3599,5006,1595,226,51,19385
2021-02-13,13,9011,3613,4773,1580,214,51,19242
2021-02-13,14,9014,3350,4677,1533,217,51,18842
2021-02-13,15,9014,3537,4741,1626,138,52,19108
2021-02-13,16,9014,3693,4969,1509,66,52,19303
2021-02-13,17,9020,4433,5195,1303,27,52,20030
2021-02-13,18,9026,4604,5520,1242,1,53,20446
2021-02-13,19,9019,4744,5647,1324,0,52,20786
2021-02-13,20,9021,4379,5606,1279,0,51,20336
2021-02-13,21,9010,4106,5265,1159,0,51,19591
2021-02-13,22,9000,4283,4811,964,0,51,19109
2021-02-13,23,8683,4581,4582,705,0,51,18602
2021-02-13,24,8654,4278,4425,516,0,51,17924
2021-02-14,1,8653,3583,4200,486,0,51,16973
2021-02-14,2,8659,2646,4011,554,0,51,15921
2021-02-14,3,8658,2436,3775,582,0,51,15502
2021-02-14,4,8662,2285,3867,636,0,51,15501
2021-02-14,5,8669,2214,3779,449,0,51,15162
2021-02-14,6,8673,2123,4059,446,0,51,15352
2021-02-14,7,8678,2565,4208,351,1,51,15854
2021-02-14,8,8681,3056,4544,331,2,50,16664
2021-02-14,9,8679,3392,4792,314,23,51,17251
2021-02-14,10,8665,2962,4705,290,68,13,16703
2021-02-14,11,8667,2884,4637,258,168,0,16614
2021-02-14,12,8659,2764,3941,306,316,0,15986
2021-02-14,13,8655,2757,3715,258,287,0,15672
2021-02-14,14,8660,2794,3679,142,73,0,15348
2021-02-14,15,8658,2829,3716,182,296,0,15681
2021-02-14,16,8659,2841,3896,207,244,1,15848
2021-02-14,17,8659,2854,4771,289,111,17,16701
2021-02-14,18,8643,3308,5570,329,12,51,17913
2021-02-14,19,8638,4069,5581,320,0,51,18659
2021-02-14,20,8641,3958,5541,347,0,51,18538
2021-02-14,21,8637,3513,5357,466,0,51,18024
2021-02-14,22,8635,3216,4973,458,0,51,17333
2021-02-14,23,8637,2722,4557,477,0,51,16444
2021-02-14,24,8646,2136,4456,544,0,51,15833
2021-02-15,1,8708,1923,4445,504,0,51,15631
2021-02-15,2,8730,1788,4386,549,0,51,15504
2021-02-15,3,8727,1885,4341,675,0,51,15679
2021-02-15,4,8725,2008,4278,683,0,51,15745
2021-02-15,5,8719,2124,3812,817,0,51,15523
2021-02-15,6,8714,2405,3912,928,0,51,16010
2021-02-15,7,8724,2591,4247,1076,2,51,16691
2021-02-15,8,8724,2801,4504,1012,5,51,17097
2021-02-15,9,8720,2807,5058,896,30,50,17561
2021-02-15,10,8723,2808,5050,971,84,51,17687
2021-02-15,11,8723,2862,4814,992,107,51,17549
2021-02-15,12,8726,2930,4619,828,182,51,17336
2021-02-15,13,8725,2847,4493,770,242,51,17128
2021-02-15,14,8726,2637,4385,949,198,51,16946
2021-02-15,15,8725,2600,4128,1355,131,51,16990
2021-02-15,16,8721,2605,4350,1589,86,51,17402
2021-02-15,17,8722,2610,4924,1857,41,51,18205
2021-02-15,18,8724,2974,5506,2212,4,51,19471
2021-02-15,19,8725,2986,5560,2334,0,51,19656
2021-02-15,20,8722,2610,4915,2937,0,51,19235
2021-02-15,21,8720,1866,4681,3346,0,51,18664
2021-02-15,22,8711,1493,4104,3558,0,51,17917
2021-02-15,23,8716,1032,3803,3624,0,51,17226
2021-02-15,24,8711,708,3781,3819,0,51,17070
2021-02-16,1,8712,521,4057,3929,0,51,17270
2021-02-16,2,8709,494,3449,4146,0,51,16849
2021-02-16,3,8710,569,3433,3644,0,51,16407
2021-02-16,4,8712,784,3387,3962,0,62,16907
2021-02-16,5,8706,1176,3354,4061,0,70,17367
2021-02-16,6,8662,1467,3520,3631,0,68,17348
2021-02-16,7,8611,1805,3898,3770,1,73,18158
2021-02-16,8,8614,2533,4545,3490,2,81,19265
2021-02-16,9,8610,2943,4478,3192,12,81,19316
2021-02-16,10,8610,2974,4369,2777,39,81,18850
2021-02-16,11,8612,3051,4951,2579,79,81,19353
2021-02-16,12,8623,3393,5015,1979,101,81,19192
2021-02-16,13,8617,3754,4809,1578,112,81,18951
2021-02-16,14,8617,3754,4717,1692,115,81,18976
2021-02-16,15,8628,3150,4718,2102,107,81,18786
2021-02-16,16,8708,2955,4715,2195,119,81,18773
2021-02-16,17,8700,2915,4841,2257,84,81,18878
2021-02-16,18,8696,2991,5793,2232,17,80,19809
2021-02-16,19,8697,3611,5908,1957,0,82,20255
2021-02-16,20,8697,3816,5707,1811,0,81,20112
2021-02-16,21,8695,3355,5398,1813,0,80,19341
2021-02-16,22,8694,3089,5024,1717,0,80,18604
2021-02-16,23,8697,2779,4396,1703,0,80,17655
2021-02-16,24,8693,2599,4205,1493,0,71,17061
2021-02-17,1,8696,2280,4432,1368,0,66,16842
2021-02-17,2,8702,2018,4272,1162,0,65,16219
2021-02-17,3,8728,2174,4251,948,0,65,16166
2021-02-17,4,8791,2419,4167,867,0,66,16310
2021-02-17,5,8799,2560,3948,818,0,66,16191
2021-02-17,6,8799,2708,4233,934,0,74,16748
2021-02-17,7,8800,3656,4740,910,3,80,18189
2021-02-17,8,8795,4329,5309,750,10,82,19275
2021-02-17,9,8796,4559,5354,583,90,82,19464
2021-02-17,10,8801,4021,5232,381,196,82,18713
2021-02-17,11,8797,4109,5084,323,263,81,18657
2021-02-17,12,8794,3959,4915,323,292,82,18365
2021-02-17,13,8793,3988,4724,313,282,57,18157
2021-02-17,14,8794,3786,4892,342,261,31,18106
2021-02-17,15,8799,3611,4903,423,209,41,17986
2021-02-17,16,8889,3905,5052,381,103,80,18410
2021-02-17,17,9055,3784,5544,245,57,79,18764
2021-02-17,18,9083,4618,5766,151,10,80,19708
2021-02-17,19,9081,5070,5743,195,0,79,20168
2021-02-17,20,9083,4684,5711,278,0,81,19837
2021-02-17,21,9081,4419,5420,287,0,81,19288
2021-02-17,22,9082,4115,5148,307,0,82,18734
2021-02-17,23,9082,3628,4774,407,0,82,17973
2021-02-17,24,9084,2650,4603,551,0,71,16959
2021-02-18,1,9108,2310,4248,665,0,66,16397
2021-02-18,2,9150,2324,3794,886,0,68,16222
2021-02-18,3,9153,2418,3639,761,0,68,16039
2021-02-18,4,9153,2500,3644,644,0,68,16009
2021-02-18,5,9149,2569,3620,957,0,70,16365
2021-02-18,6,9142,2771,3718,1209,0,71,16911
2021-02-18,7,9146,3079,4761,1468,2,80,18536
2021-02-18,8,9152,3823,5305,1489,7,83,19859
2021-02-18,9,9152,3834,5419,1324,62,83,19874
2021-02-18,10,9153,3909,5337,1032,99,83,19613
2021-02-18,11,9155,3835,5179,956,127,83,19335
2021-02-18,12,9094,3602,4906,847,173,83,18705
2021-02-18,13,9116,3620,4882,810,155,83,18666
2021-02-18,14,9109,3693,4718,888,178,83,18669
2021-02-18,15,8613,3413,4852,902,130,83,17993
2021-02-18,16,8695,3485,5068,907,86,77,18318
2021-02-18,17,9129,3793,5342,1030,41,81,19416
2021-02-18,18,9133,4154,5728,964,7,83,20069
2021-02-18,19,9132,4304,5841,907,2,83,20269
2021-02-18,20,9131,4142,5844,896,2,82,20097
2021-02-18,21,9136,4028,5451,863,2,82,19562
2021-02-18,22,9136,3823,5008,720,2,82,18771
2021-02-18,23,9148,3404,4551,606,1,81,17791
2021-02-18,24,9148,2595,4296,610,1,73,16723
2021-02-19,1,8974,2362,4395,471,1,69,16272
2021-02-19,2,9148,2045,4161,401,1,68,15824
2021-02-19,3,8754,2339,4295,368,1,68,15825
2021-02-19,4,8621,2695,4205,375,1,67,15964
2021-02-19,5,8623,2949,4236,298,1,67,16174
2021-02-19,6,8627,3171,4436,295,1,70,16600
2021-02-19,7,8632,3953,5050,339,0,80,18054
2021-02-19,8,8629,4427,5475,311,1,83,18926
2021-02-19,9,8572,5054,5389,197,12,83,19307
2021-02-19,10,8564,5227,5363,160,34,84,19432
2021-02-19,11,8548,4911,5190,214,62,84,19009
2021-02-19,12,8569,4547,5138,256,173,84,18767
2021-02-19,13,8552,4141,4800,320,164,47,18024
2021-02-19,14,8270,3417,4790,451,122,32,17082
2021-02-19,15,8547,3907,4803,528,103,32,17920
2021-02-19,16,8557,3378,5146,555,81,33,17750
2021-02-19,17,8590,3355,5607,613,52,33,18250
2021-02-19,18,8628,3708,5859,649,10,71,18925
2021-02-19,19,8630,3887,5859,821,0,77,19274
2021-02-19,20,8628,3261,5966,837,0,85,18777
2021-02-19,21,8628,3171,5464,935,0,87,18285
2021-02-19,22,8631,3664,4989,932,0,99,18315
2021-02-19,23,8625,2778,4535,933,0,84,16955
2021-02-19,24,8628,1966,4371,926,0,73,15964
2021-02-20,1,8629,1495,4286,1000,0,56,15466
2021-02-20,2,8634,1028,4148,1096,0,53,14959
2021-02-20,3,8626,918,4113,1176,0,53,14886
2021-02-20,4,8625,933,3979,1108,0,53,14698
2021-02-20,5,8625,1276,4236,981,0,53,15171
2021-02-20,6,8630,1570,4411,965,0,53,15629
2021-02-20,7,8625,1842,4396,1065,3,53,15984
2021-02-20,8,8627,1932,4530,1006,5,53,16153
2021-02-20,9,8563,2509,4804,895,27,53,16851
2021-02-20,10,8565,2722,4822,744,83,53,16989
2021-02-20,11,8570,2786,4512,671,158,12,16709
2021-02-20,12,8573,2475,4085,720,222,5,16080
2021-02-20,13,8610,2283,3816,806,268,6,15789
2021-02-20,14,8613,2123,3851,913,266,0,15766
2021-02-20,15,8576,1528,3882,792,292,0,15070
2021-02-20,16,8632,1411,4036,829,220,0,15128
2021-02-20,17,8636,1415,4706,989,122,0,15868
2021-02-20,18,8633,1491,5620,1055,28,0,16827
2021-02-20,19,8632,1866,5789,1287,0,0,17574
2021-02-20,20,8636,1793,5706,1536,0,0,17671
2021-02-20,21,8633,1475,5775,1610,0,0,17493
2021-02-20,22,8637,1331,4653,1670,0,0,16291
2021-02-20,23,8631,1080,4152,1664,0,0,15527
2021-02-20,24,8640,886,4021,1453,0,0,15000
2021-02-21,1,8634,991,4259,1233,0,0,15117
2021-02-21,2,8639,876,4189,1129,0,0,14833
2021-02-21,3,8640,835,4119,916,0,0,14510
2021-02-21,4,8653,1053,4381,768,0,0,14855
2021-02-21,5,8658,1272,4180,753,0,0,14863
2021-02-21,6,8658,1284,3977,838,0,0,14757
2021-02-21,7,8659,1292,4448,734,2,0,15135
2021-02-21,8,8657,1290,5070,669,19,0,15705
2021-02-21,9,8655,1130,5111,850,88,0,15834
2021-02-21,10,8650,1066,4885,1078,215,0,15894
2021-02-21,11,8652,908,4635,1193,320,0,15708
2021-02-21,12,8652,896,4246,1352,370,0,15516
2021-02-21,13,8653,1012,4094,1432,399,0,15590
2021-02-21,14,8653,1161,3890,1441,415,1,15561
2021-02-21,15,8652,1196,4023,1461,385,1,15718
2021-02-21,16,8648,1116,4245,1395,243,0,15647
2021-02-21,17,8654,1117,4939,1445,94,0,16249
2021-02-21,18,8655,1107,5496,2094,15,0,17367
2021-02-21,19,8660,1119,5527,2678,0,0,17984
2021-02-21,20,8655,1128,5274,3012,0,0,18069
2021-02-21,21,8653,800,4987,3337,0,0,17777
2021-02-21,22,8663,340,4235,3414,0,0,16652
2021-02-21,23,8663,262,4091,3485,0,0,16501
2021-02-21,24,8689,261,3579,3508,0,0,16037
2021-02-22,1,8686,230,3459,3560,0,2,15937
2021-02-22,2,8684,285,3450,3737,0,12,16168
2021-02-22,3,8687,300,3430,3705,0,16,16138
2021-02-22,4,8686,647,3324,3595,0,17,16269
2021-02-22,5,8686,1050,3324,3293,0,17,16370
2021-02-22,6,8689,1256,3331,3199,0,19,16494
2021-02-22,7,8689,1258,3637,3397,1,27,17009
2021-02-22,8,8685,1258,3992,3685,4,31,17655
2021-02-22,9,8687,1258,4249,3964,17,31,18206
2021-02-22,10,8691,1257,4397,3928,31,31,18335
2021-02-22,11,8692,1294,4808,3916,55,31,18796
2021-02-22,12,8689,978,4792,3857,69,45,18430
2021-02-22,13,8693,1033,4808,3905,71,46,18556
2021-02-22,14,8698,925,4504,3875,89,59,18150
2021-02-22,15,8698,972,4619,3729,65,66,18149
2021-02-22,16,8690,1035,4554,3976,37,62,18354
2021-02-22,17,8687,817,4896,4091,16,54,18561
2021-02-22,18,8689,842,5733,3903,4,46,19217
2021-02-22,19,8695,1121,5616,3947,0,42,19421
2021-02-22,20,8693,1036,5207,4018,0,33,18987
2021-02-22,21,8682,715,5023,4038,0,33,18491
2021-02-22,22,8683,556,4349,3955,0,33,17576
2021-02-22,23,8689,426,4050,3914,0,32,17111
2021-02-22,24,8691,265,3520,3800,0,28,16304
2021-02-23,1,8694,202,3151,4033,0,19,16099
2021-02-23,2,8699,203,2984,4033,0,18,15937
2021-02-23,3,8697,205,2986,3936,0,17,15841
2021-02-23,4,8704,206,3056,3799,0,18,15783
2021-02-23,5,8704,234,3018,3728,0,18,15702
2021-02-23,6,8701,237,3145,3395,0,21,15499
2021-02-23,7,8700,273,3448,3518,1,28,15968
2021-02-23,8,8705,398,4462,3856,4,31,17456
2021-02-23,9,8701,481,4683,3781,16,31,17693
2021-02-23,10,8698,502,4859,3765,56,31,17911
2021-02-23,11,8691,750,4627,3727,80,31,17906
2021-02-23,12,8699,899,4392,3697,111,31,17829
2021-02-23,13,8698,1123,4606,3476,144,31,18078
2021-02-23,14,8699,1295,4380,3359,143,31,17907
2021-02-23,15,8710,1333,3900,3319,129,31,17422
2021-02-23,16,8702,1539,3921,2899,106,31,17198
2021-02-23,17,8697,1779,4383,2592,69,31,17551
2021-02-23,18,8703,1821,5081,2782,27,31,18445
2021-02-23,19,8704,1819,4942,2991,0,32,18488
2021-02-23,20,8701,1495,4985,3052,0,42,18275
2021-02-23,21,8702,893,4808,3018,0,40,17461
2021-02-23,22,8699,669,4900,2940,0,32,17240
2021-02-23,23,8700,389,4134,2610,0,32,15865
2021-02-23,24,8707,211,4360,2094,0,25,15397
2021-02-24,1,8706,205,3944,1702,0,18,14575
2021-02-24,2,8690,291,3795,1467,0,18,14261
2021-02-24,3,8700,290,3639,1360,0,18,14007
2021-02-24,4,8690,261,3450,1267,0,18,13686
2021-02-24,5,8706,328,3622,1204,0,18,13878
2021-02-24,6,8701,431,3330,1628,0,20,14110
2021-02-24,7,8704,468,3834,2375,1,27,15409
2021-02-24,8,8705,517,4316,2780,18,31,16367
2021-02-24,9,8703,642,4403,2849,106,31,16734
2021-02-24,10,8700,643,4215,3093,188,31,16870
2021-02-24,11,8700,642,4235,3166,257,31,17031
2021-02-24,12,8706,495,3962,3203,277,24,16667
2021-02-24,13,8709,427,3908,3339,259,25,16667
2021-02-24,14,8550,427,3955,3560,221,31,16744
2021-02-24,15,8593,395,3895,3572,207,31,16693
2021-02-24,16,8707,239,4059,3151,135,32,16323
2021-02-24,17,8707,296,4364,3629,59,32,17087
2021-02-24,18,8701,414,4425,4240,9,31,17820
2021-02-24,19,8704,610,4573,4172,0,30,18089
2021-02-24,20,8699,608,4642,4130,0,31,18110
2021-02-24,21,8695,608,4588,4175,0,30,18096
2021-02-24,22,8696,610,4575,3721,0,30,17632
2021-02-24,23,8691,516,4931,3162,0,30,17330
2021-02-24,24,8697,430,4264,2988,0,22,16401
2021-02-25,1,8699,252,3957,2701,0,16,15625
2021-02-25,2,8699,220,3599,2735,0,16,15269
2021-02-25,3,8699,277,3570,2651,0,16,15213
2021-02-25,4,8697,470,3716,2463,0,16,15362
2021-02-25,5,8692,785,3717,2251,0,15,15460
2021-02-25,6,8643,1352,3837,1668,0,19,15519
2021-02-25,7,8593,1795,4700,1239,2,27,16356
2021-02-25,8,8590,2473,5261,826,27,30,17207
2021-02-25,9,8589,2777,5082,519,115,31,17113
2021-02-25,10,8588,2304,5070,446,266,30,16704
2021-02-25,11,8588,1938,4769,406,372,31,16104
2021-02-25,12,8588,1668,4749,545,408,30,15988
2021-02-25,13,8591,1489,4647,630,429,31,15817
2021-02-25,14,8592,1450,4424,714,409,31,15620
2021-02-25,15,8682,1283,4379,543,410,31,15328
2021-02-25,16,8682,1486,4359,577,346,31,15481
2021-02-25,17,8684,1815,4695,797,193,31,16215
2021-02-25,18,8686,2161,5355,1141,37,30,17410
2021-02-25,19,8680,2386,5202,1444,0,30,17742
2021-02-25,20,8667,2612,5396,1578,0,30,18283
2021-02-25,21,8662,2002,5333,1739,0,30,17766
2021-02-25,22,8663,1513,4769,1956,0,30,16931
2021-02-25,23,8665,986,4357,1754,0,30,15792
2021-02-25,24,8683,837,4211,1458,0,23,15212
2021-02-26,1,8683,832,3991,1116,0,18,14640
2021-02-26,2,8682,922,3903,884,0,17,14408
2021-02-26,3,8684,1128,3852,616,0,17,14297
2021-02-26,4,8683,1277,3923,463,0,17,14363
2021-02-26,5,8687,1513,3767,490,0,17,14474
2021-02-26,6,8688,1633,4103,583,0,20,15027
2021-02-26,7,8683,1714,4662,831,1,27,15918
2021-02-26,8,8685,1797,5018,1204,43,31,16778
2021-02-26,9,8680,1713,4435,1343,188,31,16390
2021-02-26,10,8682,1628,4338,1262,333,31,16274
2021-02-26,11,8682,1344,4315,1639,393,31,16404
2021-02-26,12,8681,1198,4438,1703,387,32,16439
2021-02-26,13,8684,1029,4319,1523,346,31,15932
2021-02-26,14,8684,1041,3940,1332,342,32,15371
2021-02-26,15,8686,1171,4047,1075,347,31,15357
2021-02-26,16,8690,1335,4152,621,310,31,15139
2021-02-26,17,8690,1553,4446,698,157,31,15575
2021-02-26,18,8687,1664,4512,1720,45,30,16658
2021-02-26,19,8689,1654,4558,2565,0,30,17496
2021-02-26,20,8682,1611,4528,2903,0,32,17756
2021-02-26,21,8684,1159,4456,3081,0,31,17411
2021-02-26,22,8677,908,4134,2929,0,31,16679
2021-02-26,23,8676,463,3970,3261,0,31,16401
2021-02-26,24,8674,232,3647,3192,0,23,15768
2021-02-27,1,8667,203,3684,2768,0,8,15330
2021-02-27,2,8663,201,3591,2909,0,0,15364
2021-02-27,3,8669,201,3070,2900,0,0,14840
2021-02-27,4,8671,202,3112,2958,0,0,14943
2021-02-27,5,8675,201,3222,2988,0,0,15086
2021-02-27,6,8681,200,3377,3019,0,0,15277
2021-02-27,7,8678,204,3515,3235,1,0,15633
2021-02-27,8,8677,203,4047,3484,5,0,16416
2021-02-27,9,8676,254,4450,3108,21,0,16509
2021-02-27,10,8674,442,5226,2612,31,0,16985
2021-02-27,11,8678,818,4502,2446,79,0,16523
2021-02-27,12,8681,738,4705,2076,113,0,16313
2021-02-27,13,8685,540,4265,1911,156,0,15557
2021-02-27,14,8683,645,3948,1641,175,0,15092
2021-02-27,15,8679,872,3822,1602,196,0,15171
2021-02-27,16,8679,1047,3883,1658,223,0,15490
2021-02-27,17,8679,1128,4337,1333,129,0,15606
2021-02-27,18,8686,1244,4591,1758,33,0,16312
2021-02-27,19,8680,1228,5427,1571,0,0,16906
2021-02-27,20,8680,1215,5278,1415,0,0,16588
2021-02-27,21,8682,1152,5133,1199,0,0,16166
2021-02-27,22,8682,1062,4313,1463,0,0,15520
2021-02-27,23,8682,660,3826,1395,0,0,14563
2021-02-27,24,8679,435,3846,1275,0,0,14235
2021-02-28,1,8677,236,4250,973,0,0,14136
2021-02-28,2,8678,234,4364,670,0,0,13946
2021-02-28,3,8673,263,4161,623,0,0,13720
2021-02-28,4,8676,205,3724,804,0,0,13409
2021-02-28,5,8685,204,3396,1291,0,0,13576
2021-02-28,6,8685,203,3266,1331,0,0,13485
2021-02-28,7,8686,203,3365,1621,2,0,13877
2021-02-28,8,8683,207,3671,1701,11,0,14273
2021-02-28,9,8685,212,3961,1879,41,0,14778
2021-02-28,10,8677,286,4050,2491,73,0,15577
2021-02-28,11,8678,438,4053,3100,113,0,16382
2021-02-28,12,8673,584,4233,2561,126,0,16177
2021-02-28,13,8675,592,4175,2436,145,0,16023
2021-02-28,14,8675,627,3738,2335,212,0,15587
2021-02-28,15,8678,687,3756,2089,152,0,15362
2021-02-28,16,8678,833,3644,2321,84,0,15560
2021-02-28,17,8678,833,4057,2435,44,0,16047
2021-02-28,18,8680,478,4848,2973,10,0,16989
2021-02-28,19,8680,375,4539,3517,0,11,17122
2021-02-28,20,8680,374,4193,3538,0,34,16819
2021-02-28,21,8686,374,4130,3451,0,51,16692
2021-02-28,22,8687,260,3668,3810,0,53,16478
2021-02-28,23,8684,195,3563,3810,0,54,16306
2021-02-28,24,8686,194,3204,3412,0,54,15550
2021-03-01,1,8689,198,3133,2834,0,54,14908
2021-03-01,2,8687,272,3042,2525,0,56,14582
2021-03-01,3,8683,304,3052,2303,0,65,14407
2021-03-01,4,8667,305,3037,2350,0,63,14422
2021-03-01,5,8676,305,3068,2753,0,69,14871
2021-03-01,6,8689,305,3349,2530,0,70,14943
2021-03-01,7,8688,355,4031,2753,2,77,15906
2021-03-01,8,8678,418,4500,3396,9,84,17085
2021-03-01,9,8672,463,4344,3455,52,84,17070
2021-03-01,10,8670,507,4606,3478,97,84,17442
2021-03-01,11,8682,618,4399,3483,137,46,17365
2021-03-01,12,8677,830,4277,3788,151,33,17756
2021-03-01,13,8677,1053,3671,4031,185,34,17651
2021-03-01,14,8676,1057,3730,3968,224,31,17686
2021-03-01,15,8677,1055,3708,4040,214,31,17725
2021-03-01,16,8666,1374,3821,3485,186,31,17563
2021-03-01,17,8671,1519,4275,3591,126,31,18213
2021-03-01,18,8673,1648,4695,4127,39,31,19213
2021-03-01,19,8669,1633,5241,4363,0,31,19937
2021-03-01,20,8671,1482,5120,4116,0,31,19420
2021-03-01,21,8669,1448,4968,3891,0,32,19008
2021-03-01,22,8670,1455,4463,3656,0,33,18277
2021-03-01,23,8671,1130,4133,3482,0,56,17472
2021-03-01,24,8669,865,3516,3404,0,74,16528
2021-03-02,1,8669,853,3613,3195,0,56,16386
2021-03-02,2,8665,855,3624,2788,0,65,15997
2021-03-02,3,8663,876,3813,2596,0,68,16016
2021-03-02,4,8663,985,3852,1845,0,69,15414
2021-03-02,5,8669,1466,4350,1103,0,70,15658
2021-03-02,6,8638,2358,4218,753,0,71,16038
2021-03-02,7,8579,3086,4857,591,0,83,17196
2021-03-02,8,8583,2939,5245,555,36,86,17444
2021-03-02,9,8582,2851,5433,499,126,87,17578
2021-03-02,10,8581,2570,5504,457,228,48,17388
2021-03-02,11,8581,2633,5193,579,329,32,17347
2021-03-02,12,8588,2493,4646,1000,366,33,17126
2021-03-02,13,8587,2135,3819,1282,395,33,16251
2021-03-02,14,8590,1780,3918,1184,381,31,15884
2021-03-02,15,8652,1687,3885,1864,380,31,16499
2021-03-02,16,8668,1693,3966,2395,311,31,17064
2021-03-02,17,8670,1665,4086,2855,145,40,17461
2021-03-02,18,8672,1478,4575,3631,33,74,18463
2021-03-02,19,8671,1881,4750,3809,0,85,19196
2021-03-02,20,8668,1880,4495,3793,0,85,18921
2021-03-02,21,8666,1673,4404,3919,0,85,18747
2021-03-02,22,8669,1383,3805,4168,0,85,18110
2021-03-02,23,8675,578,3485,4132,0,85,16955
2021-03-02,24,8678,257,3295,3476,0,76,15782
2021-03-03,1,8680,209,3159,3570,0,73,15691
2021-03-03,2,8684,206,3115,3544,0,74,15623
2021-03-03,3,8676,217,3135,3214,0,73,15315
2021-03-03,4,8687,302,3106,3304,0,20,15419
2021-03-03,5,8686,477,3143,3109,0,17,15432
2021-03-03,6,8694,618,3246,2709,0,18,15285
2021-03-03,7,8688,772,4258,2356,2,25,16101
2021-03-03,8,8691,1175,4818,1986,13,29,16712
2021-03-03,9,8695,1672,4935,1500,73,31,16906
2021-03-03,10,8693,1872,4947,922,132,31,16597
2021-03-03,11,8697,1828,4182,642,234,31,15614
2021-03-03,12,8698,1633,4286,471,283,31,15402
2021-03-03,13,8695,1652,4405,418,280,31,15481
2021-03-03,14,8694,1742,4136,532,266,31,15401
2021-03-03,15,8693,1845,3799,562,228,32,15159
2021-03-03,16,8698,2152,3876,432,152,31,15341
2021-03-03,17,8689,2364,4247,461,96,32,15889
2021-03-03,18,8688,2413,5174,591,29,62,16957
2021-03-03,19,8686,2245,5340,866,0,83,17220
2021-03-03,20,8681,2238,5189,1069,0,85,17262
2021-03-03,21,8680,1874,4998,1089,0,86,16727
2021-03-03,22,8686,1510,4280,1474,0,87,16037
2021-03-03,23,8690,1245,3918,1486,0,87,15426
2021-03-03,24,8692,746,3432,1676,0,76,14622
2021-03-04,1,8690,502,3455,1746,0,69,14462
2021-03-04,2,8684,424,3268,1650,0,69,14095
2021-03-04,3,8691,388,3206,1631,0,69,13985
2021-03-04,4,8695,515,3190,1722,0,29,14151
2021-03-04,5,8693,644,3236,1253,0,16,13842
2021-03-04,6,8688,800,3360,1453,1,21,14323
2021-03-04,7,8677,801,4003,1700,2,24,15207
2021-03-04,8,8676,840,4290,2282,34,31,16153
2021-03-04,9,8681,1063,4234,2207,127,31,16343
2021-03-04,10,8676,1153,4181,2116,232,31,16389
2021-03-04,11,8682,1154,4215,2213,345,31,16640
2021-03-04,12,8675,930,4126,2353,363,31,16478
2021-03-04,13,8670,1113,4084,2701,362,31,16961
2021-03-04,14,8674,1557,4066,2396,384,31,17108
2021-03-04,15,8669,1949,3984,2084,403,30,17119
2021-03-04,16,8666,2213,4169,1150,342,30,16570
2021-03-04,17,8663,2340,4406,1100,187,30,16726
2021-03-04,18,8660,2258,4747,2205,64,34,17968
2021-03-04,19,8660,2264,5172,2447,0,33,18576
2021-03-04,20,8663,2218,5111,2347,0,30,18369
2021-03-04,21,8664,2042,4773,2303,0,31,17813
2021-03-04,22,8657,1698,4349,2214,0,31,16949
2021-03-04,23,8659,991,4614,2116,0,31,16411
2021-03-04,24,8668,665,4131,2058,0,19,15541
2021-03-05,1,8660,617,3465,2104,0,17,14863
2021-03-05,2,8644,620,3403,1847,0,15,14529
2021-03-05,3,8644,317,3713,1988,0,15,14677
2021-03-05,4,8651,413,3306,2111,0,15,14496
2021-03-05,5,8654,720,3177,2190,0,15,14756
2021-03-05,6,8660,986,3372,2069,1,19,15107
2021-03-05,7,8660,984,4123,2555,2,24,16348
2021-03-05,8,8660,996,5023,2717,71,30,17497
2021-03-05,9,8661,1020,4735,2757,227,31,17431
2021-03-05,10,8662,839,4410,2820,360,30,17121
2021-03-05,11,8662,642,4260,2833,398,32,16827
2021-03-05,12,8661,299,4300,3165,408,31,16864
2021-03-05,13,8660,206,3898,3451,409,30,16654
2021-03-05,14,8655,203,4125,3274,388,30,16675
2021-03-05,15,8657,216,4264,2943,328,30,16438
2021-03-05,16,8661,330,4309,3379,267,32,16978
2021-03-05,17,8661,601,4453,3325,125,32,17197
2021-03-05,18,8656,994,4966,3306,30,31,17983
2021-03-05,19,8655,1030,5478,3411,0,31,18605
2021-03-05,20,8656,1022,5416,3458,0,31,18583
2021-03-05,21,8650,987,4607,3579,0,31,17854
2021-03-05,22,8649,825,3888,3660,0,31,17053
2021-03-05,23,8654,798,3619,3564,0,31,16666
2021-03-05,24,8650,310,3793,3324,0,21,16098
2021-03-06,1,8650,207,3897,2966,0,3,15723
2021-03-06,2,8650,216,4217,2529,0,0,15612
2021-03-06,3,8650,293,4014,2273,0,0,15230
2021-03-06,4,8649,268,3941,2060,0,0,14918
2021-03-06,5,8651,216,3861,2024,0,0,14752
2021-03-06,6,8651,250,3891,1886,0,0,14678
2021-03-06,7,8646,443,4639,1879,2,0,15609
2021-03-06,8,8645,404,4572,2045,26,0,15692
2021-03-06,9,8645,404,4472,2115,100,0,15736
2021-03-06,10,8647,588,4334,1997,181,0,15747
2021-03-06,11,8537,791,4386,2085,217,0,16016
2021-03-06,12,8507,959,4287,2051,285,0,16089
2021-03-06,13,8502,1257,4368,1931,342,0,16400
2021-03-06,14,8498,1379,4039,1849,318,4,16087
2021-03-06,15,8505,1417,4091,1841,293,4,16151
2021-03-06,16,8468,1443,3734,1830,225,0,15700
2021-03-06,17,8423,1515,4098,1438,130,0,15604
2021-03-06,18,8432,1802,4574,1176,48,0,16032
2021-03-06,19,8437,2187,5569,1033,1,0,17227
2021-03-06,20,8437,2477,5486,922,0,0,17322
2021-03-06,21,8439,2248,5437,783,0,0,16907
2021-03-06,22,8433,2398,5170,791,0,0,16792
2021-03-06,23,8433,1835,4960,660,0,0,15888
2021-03-06,24,8434,1248,4862,504,0,0,15048
2021-03-07,1,8436,410,4567,678,0,0,14091
2021-03-07,2,8433,269,4234,693,0,0,13629
2021-03-07,3,8429,210,4212,681,0,0,13532
2021-03-07,4,8435,212,4355,577,0,0,13579
2021-03-07,5,8438,339,4746,473,0,0,13996
2021-03-07,6,8434,581,4766,322,2,0,14105
2021-03-07,7,8434,808,4584,386,3,0,14215
2021-03-07,8,8436,677,4634,422,87,0,14256
2021-03-07,9,8432,709,4782,249,253,0,14425
2021-03-07,10,8430,854,4626,198,381,0,14489
2021-03-07,11,8431,1020,4736,202,411,0,14800
2021-03-07,12,8434,1165,4723,184,398,0,14904
2021-03-07,13,8432,1383,4310,176,406,2,14709
2021-03-07,14,8432,1494,3943,225,400,2,14496
2021-03-07,15,8384,1717,3482,245,381,0,14209
2021-03-07,16,8438,2017,3474,226,240,0,14395
2021-03-07,17,8434,2325,3829,248,117,0,14953
2021-03-07,18,8435,2315,4665,418,47,0,15880
2021-03-07,19,8435,2506,5666,547,0,0,17154
2021-03-07,20,8432,3153,5540,534,0,0,17659
2021-03-07,21,8430,2907,5336,556,0,0,17229
2021-03-07,22,8429,2382,5068,649,0,0,16528
2021-03-07,23,8428,1329,4776,705,0,0,15238
2021-03-07,24,8430,749,4501,903,0,0,14583
2021-03-08,1,8428,586,4296,1109,0,0,14419
2021-03-08,2,8436,594,4021,1352,0,9,14412
2021-03-08,3,8433,549,3984,1680,0,12,14658
2021-03-08,4,8432,665,3573,1892,0,16,14578
2021-03-08,5,8436,929,3261,2135,0,19,14780
2021-03-08,6,8438,1191,3801,2028,1,20,15479
2021-03-08,7,8433,1183,4511,2703,4,29,16863
2021-03-08,8,8436,1183,5114,2959,53,32,17777
2021-03-08,9,8436,1202,5354,3141,136,32,18301
2021-03-08,10,8434,1109,4858,3118,226,32,17777
2021-03-08,11,8432,667,4306,3060,244,32,16741
2021-03-08,12,8432,259,4322,3119,262,33,16427
2021-03-08,13,8436,324,4062,3267,275,32,16396
2021-03-08,14,8436,470,3854,3433,267,33,16493
2021-03-08,15,8435,711,3705,3470,267,33,16621
2021-03-08,16,8433,880,3787,3371,203,32,16706
2021-03-08,17,8434,1072,4051,3425,68,33,17083
2021-03-08,18,8431,1348,4796,3239,27,32,17873
2021-03-08,19,8436,1903,4752,3131,0,31,18253
2021-03-08,20,8436,1553,4296,3038,0,31,17354
2021-03-08,21,8436,945,4052,3101,0,31,16565
2021-03-08,22,8433,675,3828,2659,0,31,15626
2021-03-08,23,8427,642,3696,2290,0,31,15086
2021-03-08,24,8431,406,3539,1825,0,21,14222
2021-03-09,1,8430,398,3989,1603,0,18,14438
2021-03-09,2,8428,399,3746,1290,0,19,13882
2021-03-09,3,8428,463,4038,945,0,20,13894
2021-03-09,4,8432,754,4214,727,0,17,14144
2021-03-09,5,8435,1011,3982,539,0,17,13984
2021-03-09,6,8387,1458,3654,304,2,20,13825
2021-03-09,7,8336,1744,4676,322,2,30,15110
2021-03-09,8,8333,1817,5191,349,37,32,15759
2021-03-09,9,8333,1819,5081,269,116,32,15650
2021-03-09,10,8338,1809,4668,151,230,32,15228
2021-03-09,11,8342,1806,4025,102,235,32,14542
2021-03-09,12,8343,1136,3897,203,301,32,13912
2021-03-09,13,8351,1007,3787,365,324,32,13866
2021-03-09,14,8440,998,3621,385,313,32,13789
2021-03-09,15,8442,958,3568,431,311,31,13741
2021-03-09,16,8456,1076,3962,505,248,38,14285
2021-03-09,17,8440,1180,4374,738,148,67,14947
2021-03-09,18,8441,1184,5202,1190,48,87,16152
2021-03-09,19,8437,1183,4889,1866,1,86,16462
2021-03-09,20,8440,1184,4516,2414,1,83,16638
2021-03-09,21,8433,1029,4203,2629,1,87,16382
2021-03-09,22,8435,493,4113,3150,0,46,16237
2021-03-09,23,8418,225,3738,3335,0,40,15756
2021-03-09,24,8430,199,3272,3004,0,46,14951
2021-03-10,1,8430,198,3292,3015,0,47,14982
2021-03-10,2,8429,200,3107,3056,0,47,14839
2021-03-10,3,8421,199,2990,3112,0,46,14768
2021-03-10,4,8385,198,2951,3277,0,43,14854
2021-03-10,5,8393,199,2992,3266,0,39,14889
2021-03-10,6,8394,198,3081,3420,2,44,15139
2021-03-10,7,8393,198,3466,3627,2,59,15745
2021-03-10,8,8391,199,3947,3975,42,62,16616
2021-03-10,9,8389,200,3810,3833,126,58,16416
2021-03-10,10,8393,198,3820,3769,205,55,16440
2021-03-10,11,8382,198,3614,3879,257,55,16385
2021-03-10,12,8381,198,3529,3902,281,59,16350
2021-03-10,13,8380,197,3335,3759,280,60,16011
2021-03-10,14,8378,197,3382,3973,252,57,16239
2021-03-10,15,8380,197,3522,4091,174,59,16423
2021-03-10,16,8383,196,3774,4077,114,59,16603
2021-03-10,17,8381,197,4200,4206,59,55,17098
2021-03-10,18,8383,197,4628,4339,18,55,17620
2021-03-10,19,8383,197,4502,4038,0,54,17174
2021-03-10,20,8386,196,4463,4099,0,55,17199
2021-03-10,21,8385,197,3950,4241,0,51,16824
2021-03-10,22,8382,197,3480,4261,0,62,16382
2021-03-10,23,8379,197,3281,4262,0,56,16175
2021-03-10,24,8379,197,3103,4003,0,34,15716
2021-03-11,1,8380,198,3074,3377,0,23,15052
2021-03-11,2,8385,197,2978,2992,0,18,14570
2021-03-11,3,8381,197,3009,2727,0,17,14331
2021-03-11,4,8387,197,2940,2533,0,22,14079
2021-03-11,5,8381,197,2971,2556,0,21,14126
2021-03-11,6,8385,195,3125,2897,0,23,14625
2021-03-11,7,8384,197,3429,3905,2,29,15946
2021-03-11,8,8379,198,3899,4317,14,32,16839
2021-03-11,9,8380,280,3895,4488,40,34,17117
2021-03-11,10,8379,302,3635,4251,107,35,16709
2021-03-11,11,8382,299,3673,4163,144,30,16691
2021-03-11,12,8378,297,3491,4110,150,31,16457
2021-03-11,13,8371,304,3505,4158,118,31,16487
2021-03-11,14,8375,345,3481,4065,156,30,16452
2021-03-11,15,8371,414,3527,3979,150,30,16471
2021-03-11,16,8372,421,3866,3875,108,30,16672
2021-03-11,17,8374,422,4067,4321,49,30,17263
2021-03-11,18,8373,425,4573,4170,42,30,17613
2021-03-11,19,8374,425,4658,4155,1,30,17643
2021-03-11,20,8374,423,4716,4364,0,30,17907
2021-03-11,21,8365,292,4571,4103,0,31,17362
2021-03-11,22,8350,205,4131,4125,0,31,16842
2021-03-11,23,8363,205,3863,3828,0,31,16290
2021-03-11,24,8364,204,3523,3305,0,26,15422
2021-03-12,1,8364,204,3336,2781,0,24,14709
2021-03-12,2,8367,204,3071,2569,0,19,14230
2021-03-12,3,8375,204,3192,2197,0,17,13985
2021-03-12,4,8369,204,3343,2044,0,18,13978
2021-03-12,5,8378,204,3362,1968,0,18,13930
2021-03-12,6,8380,203,3505,1661,1,23,13773
2021-03-12,7,8386,203,4174,1367,4,29,14163
2021-03-12,8,8384,201,4607,1713,59,31,14995
2021-03-12,9,8381,202,4208,1954,162,30,14937
2021-03-12,10,8376,203,3988,1760,248,30,14605
2021-03-12,11,8380,202,3471,2431,289,31,14804
2021-03-12,12,8377,203,3311,3041,294,31,15257
2021-03-12,13,8376,205,3486,3459,286,31,15843
2021-03-12,14,8377,206,3522,3676,255,30,16066
2021-03-12,15,8373,206,3551,3838,208,31,16207
2021-03-12,16,8375,207,3600,3778,174,31,16165
2021-03-12,17,8373,208,4191,3401,144,31,16348
2021-03-12,18,8371,211,4526,4019,50,31,17208
2021-03-12,19,8373,223,4971,3991,0,31,17589
2021-03-12,20,8377,381,5441,3724,0,32,17955
2021-03-12,21,8374,245,5118,3596,0,31,17364
2021-03-12,22,8374,247,4579,3379,0,31,16610
2021-03-12,23,8374,209,4457,3041,0,31,16112
2021-03-12,24,8376,208,4219,2476,0,15,15294
2021-03-13,1,8373,278,4567,1924,0,4,15146
2021-03-13,2,8374,366,4266,1608,0,1,14615
2021-03-13,3,8375,302,3912,1307,0,0,13896
2021-03-13,4,8369,248,4101,885,0,10,13613
2021-03-13,5,8371,343,4163,425,0,33,13335
2021-03-13,6,8378,375,4516,275,2,86,13632
2021-03-13,7,8382,370,4680,264,4,96,13796
2021-03-13,8,8380,248,4552,278,63,58,13579
2021-03-13,9,8378,202,4487,291,174,54,13586
2021-03-13,10,8378,203,4523,575,265,54,13998
2021-03-13,11,8377,204,4567,956,300,54,14458
2021-03-13,12,8374,206,4301,1445,297,54,14677
2021-03-13,13,8373,199,3944,1982,301,54,14853
2021-03-13,14,8379,200,3673,2419,305,11,14987
2021-03-13,15,8379,199,3499,2494,285,0,14856
2021-03-13,16,8375,199,3564,2477,241,0,14856
2021-03-13,17,8372,198,4128,3038,151,0,15887
2021-03-13,18,8376,198,4804,3336,55,0,16769
2021-03-13,19,8376,198,4807,3684,3,0,17068
2021-03-13,20,8377,200,4722,4067,0,0,17366
2021-03-13,21,8373,201,4155,4169,0,0,16898
2021-03-13,22,8376,201,3758,3901,0,0,16236
2021-03-13,23,8379,203,3381,3948,0,0,15911
2021-03-13,24,8380,203,3078,3748,0,0,15409
2021-03-14,1,8384,201,2948,3173,0,0,14706
2021-03-14,2,8380,203,2988,2644,0,0,14215
2021-03-14,3,8374,203,3182,2550,0,0,14309
2021-03-14,4,8380,202,3117,2334,0,0,14033
2021-03-14,5,8382,204,2865,2366,0,0,13817
2021-03-14,6,8387,204,3192,1996,2,0,13781
2021-03-14,7,8384,205,3460,2189,3,0,14241
2021-03-14,8,8383,205,3461,2549,52,0,14650
2021-03-14,9,8387,206,3522,2752,163,0,15030
2021-03-14,10,8378,209,3259,3035,209,0,15090
2021-03-14,11,8377,224,3225,3006,268,0,15100
2021-03-14,12,8372,242,3204,3595,288,0,15701
2021-03-14,13,8374,243,3241,3290,310,0,15458
2021-03-14,14,8373,281,3235,2967,319,0,15175
2021-03-14,15,8368,342,3246,2877,326,0,15159
2021-03-14,16,8372,575,3332,2910,293,0,15482
2021-03-14,17,8372,577,3768,3450,194,0,16361
2021-03-14,18,8371,583,4462,3555,68,8,17047
2021-03-14,19,8370,605,4748,3269,1,31,17024
2021-03-14,20,8373,647,5296,2636,0,54,17006
2021-03-14,21,8378,674,5305,2290,0,54,16701
2021-03-14,22,8371,708,4915,1953,0,54,16001
2021-03-14,23,8378,735,4324,1853,0,53,15343
2021-03-14,24,8380,782,3831,1679,0,11,14683
2021-03-15,1,8382,974,3635,1538,0,0,14529
2021-03-15,2,8375,1062,3441,1265,0,14,14157
2021-03-15,3,8376,1145,3647,1042,0,14,14224
2021-03-15,4,8382,1346,3822,738,0,15,14303
2021-03-15,5,8383,1838,3894,718,0,24,14857
2021-03-15,6,8377,2757,4280,1002,0,66,16482
2021-03-15,7,8373,3635,4770,1176,4,95,18053
2021-03-15,8,8346,3837,4504,1240,76,100,18103
2021-03-15,9,8309,3284,4412,1349,193,85,17632
2021-03-15,10,8366,2731,4308,1570,290,80,17345
2021-03-15,11,8388,2558,3955,1598,329,82,16910
2021-03-15,12,8385,2470,3718,1642,334,83,16632
2021-03-15,13,8385,2233,3646,1738,323,82,16407
2021-03-15,14,8380,2044,3477,1667,303,83,15954
2021-03-15,15,8377,1914,3629,1650,290,83,15943
2021-03-15,16,8372,1925,4143,1561,237,84,16322
2021-03-15,17,8373,2748,4428,1589,138,83,17359
2021-03-15,18,8374,2952,4743,1352,34,85,17540
2021-03-15,19,8373,3323,5202,1682,0,86,18666
2021-03-15,20,8373,2651,5185,2014,0,83,18306
2021-03-15,21,8371,2183,4604,2290,0,83,17531
2021-03-15,22,8375,1687,4345,2317,0,83,16807
2021-03-15,23,8370,1237,3914,2218,0,73,15812
2021-03-15,24,8371,1090,3668,2334,0,68,15531
2021-03-16,1,8375,755,3050,2376,0,68,14624
2021-03-16,2,8374,683,3116,2098,0,68,14339
2021-03-16,3,8377,855,2950,1968,0,68,14218
2021-03-16,4,8385,1089,3206,1861,0,68,14609
2021-03-16,5,8345,1611,3780,1961,0,93,15790
2021-03-16,6,8296,2965,4222,1872,1,158,17514
2021-03-16,7,8294,3718,4964,1710,1,206,18893
2021-03-16,8,8296,4049,5028,1548,23,210,19154
2021-03-16,9,8304,4129,4695,1288,56,189,18661
2021-03-16,10,8308,3935,4301,975,102,192,17813
2021-03-16,11,8309,4021,4220,751,154,186,17641
2021-03-16,12,8306,3709,4208,533,183,154,17093
2021-03-16,13,8307,3684,4032,245,199,143,16610
2021-03-16,14,8307,3473,3995,110,205,151,16241
2021-03-16,15,8321,3653,3895,70,166,154,16259
2021-03-16,16,8363,3698,4196,147,132,145,16681
2021-03-16,17,8385,4273,4322,231,79,182,17472
2021-03-16,18,8387,3631,4974,243,28,126,17389
2021-03-16,19,8387,3465,5476,306,2,94,17730
2021-03-16,20,8386,3178,5438,470,0,86,17558
2021-03-16,21,8400,2475,5284,496,0,86,16741
2021-03-16,22,8411,1989,4995,333,0,85,15813
2021-03-16,23,8420,1441,4487,231,0,35,14614
2021-03-16,24,8479,1357,3658,198,0,15,13707
2021-03-17,1,8295,1327,3918,186,0,14,13740
2021-03-17,2,8269,1292,3930,124,0,15,13630
2021-03-17,3,8274,1504,4011,92,0,14,13895
2021-03-17,4,8341,1833,3568,84,0,14,13840
2021-03-17,5,8390,2371,3370,49,0,15,14195
2021-03-17,6,8440,2738,4070,66,1,50,15365
2021-03-17,7,8440,3600,4803,62,3,101,17009
2021-03-17,8,8436,3953,4405,103,29,176,17102
2021-03-17,9,8439,4107,4286,80,94,188,17194
2021-03-17,10,8441,3729,4251,70,193,188,16872
2021-03-17,11,8447,3429,3972,122,257,171,16398
2021-03-17,12,8443,2928,3849,197,277,104,15798
2021-03-17,13,8449,3020,3847,201,284,132,15933
2021-03-17,14,8447,2543,3745,191,283,85,15294
2021-03-17,15,8440,2272,3988,150,247,82,15179
2021-03-17,16,8441,2290,4223,196,195,83,15428
2021-03-17,17,8439,2596,4376,311,101,83,15906
2021-03-17,18,8443,2685,4616,524,27,83,16378
2021-03-17,19,8444,2971,4765,643,3,134,16960
2021-03-17,20,8456,1989,5265,744,0,121,16575
2021-03-17,21,8567,1046,5324,934,0,87,15958
2021-03-17,22,8608,392,5181,893,0,85,15159
2021-03-17,23,8609,264,4590,835,0,32,14330
2021-03-17,24,8608,266,4405,970,0,17,14266
2021-03-18,1,8609,227,3789,1185,0,16,13826
2021-03-18,2,8602,202,3470,1458,0,16,13748
2021-03-18,3,8602,204,3250,1688,0,16,13760
2021-03-18,4,8604,199,3194,2170,0,17,14184
2021-03-18,5,8630,204,3206,2318,0,18,14376
2021-03-18,6,8676,260,3593,2654,1,26,15210
2021-03-18,7,8677,407,4015,3024,2,32,16157
2021-03-18,8,8677,402,4389,3237,12,32,16749
2021-03-18,9,8672,402,4142,3440,40,32,16728
2021-03-18,10,8670,398,4212,3544,74,32,16930
2021-03-18,11,8675,398,3951,3763,103,32,16922
2021-03-18,12,8668,400,3854,3852,130,32,16936
2021-03-18,13,8671,312,3631,3856,143,32,16645
2021-03-18,14,8679,318,3743,3965,150,32,16887
2021-03-18,15,8678,593,3725,4117,122,32,17267
2021-03-18,16,8684,840,4189,3963,92,32,17800
2021-03-18,17,8685,827,4334,4081,64,32,18023
2021-03-18,18,8690,779,4059,4064,26,32,17650
2021-03-18,19,8687,832,4072,3891,2,32,17516
2021-03-18,20,8685,833,4716,3923,0,33,18190
2021-03-18,21,8678,833,4500,3770,0,33,17814
2021-03-18,22,8681,438,3902,3735,0,31,16787
2021-03-18,23,8679,214,3821,3686,0,19,16419
2021-03-18,24,8672,217,3280,3509,0,16,15694
2021-03-19,1,8675,227,3209,3130,0,16,15257
2021-03-19,2,8670,248,3133,3127,0,16,15194
2021-03-19,3,8675,297,3173,2980,0,16,15141
2021-03-19,4,8670,404,3389,3086,0,16,15565
2021-03-19,5,8666,503,3343,2827,0,18,15357
2021-03-19,6,8667,691,3816,2624,3,38,15839
2021-03-19,7,8671,969,4501,2485,7,89,16722
2021-03-19,8,8670,1078,4973,2239,80,146,17186
2021-03-19,9,8674,890,4436,2042,205,101,16348
2021-03-19,10,8670,802,4346,1624,302,86,15830
2021-03-19,11,8666,802,4423,1615,332,87,15925
2021-03-19,12,8684,830,4529,1206,336,85,15670
2021-03-19,13,8687,940,4178,869,336,89,15099
2021-03-19,14,8695,1017,4003,604,336,86,14741
2021-03-19,15,8697,1218,3659,531,328,86,14519
2021-03-19,16,8687,1228,4119,220,288,86,14628
2021-03-19,17,8683,1287,4489,437,172,85,15153
2021-03-19,18,8682,1409,4632,553,69,85,15430
2021-03-19,19,8680,1466,5331,601,6,85,16169
2021-03-19,20,8672,1589,5353,699,0,86,16399
2021-03-19,21,8642,1089,5086,770,0,88,15675
2021-03-19,22,7849,1000,4946,893,0,108,14796
2021-03-19,23,7853,628,4470,1053,0,32,14036
2021-03-19,24,7858,468,3520,1179,0,10,13035
2021-03-20,1,7861,405,3767,1279,0,3,13315
2021-03-20,2,7859,435,3372,1336,0,0,13002
2021-03-20,3,7857,287,3689,1287,0,0,13120
2021-03-20,4,7861,293,3669,1236,0,0,13059
2021-03-20,5,7861,421,3501,1122,0,0,12905
2021-03-20,6,7862,466,3957,1001,3,0,13289
2021-03-20,7,7859,796,4695,888,9,0,14247
2021-03-20,8,7864,915,5099,719,86,0,14683
2021-03-20,9,7865,886,5046,481,203,0,14481
2021-03-20,10,7864,754,4999,366,295,0,14278
2021-03-20,11,7855,493,4841,427,330,0,13946
2021-03-20,12,7853,440,4636,516,335,0,13780
2021-03-20,13,7853,393,3858,539,335,0,12978
2021-03-20,14,7856,370,3443,625,335,1,12630
2021-03-20,15,7851,634,3488,757,327,0,13057
2021-03-20,16,7852,645,3744,811,287,0,13339
2021-03-20,17,7860,673,4180,825,191,0,13729
2021-03-20,18,7865,739,4728,831,73,0,14236
2021-03-20,19,7862,780,5169,885,5,0,14701
2021-03-20,20,7859,779,5104,1060,0,0,14802
2021-03-20,21,7850,499,4642,1296,0,0,14287
2021-03-20,22,7860,413,4309,1591,0,0,14173
2021-03-20,23,7860,404,3729,1985,0,1,13979
2021-03-20,24,7859,404,3265,2180,0,1,13709
2021-03-21,1,7859,243,3329,2183,0,0,13614
2021-03-21,2,7859,196,3568,2061,0,0,13684
2021-03-21,3,7865,197,3463,1998,0,0,13523
2021-03-21,4,7866,197,3595,1791,0,0,13449
2021-03-21,5,7866,198,3553,1699,0,0,13316
2021-03-21,6,7861,227,3695,1643,2,0,13428
2021-03-21,7,7865,217,4115,1652,9,0,13858
2021-03-21,8,7865,256,4443,1576,79,0,14219
2021-03-21,9,7866,246,5026,1125,176,0,14439
2021-03-21,10,7858,238,5146,745,255,0,14242
2021-03-21,11,7865,230,4637,684,280,0,13696
2021-03-21,12,7866,237,4315,784,285,2,13489
2021-03-21,13,7868,217,3498,760,286,6,12635
2021-03-21,14,7873,255,3315,673,327,18,12461
2021-03-21,15,7874,351,3306,686,325,20,12562
2021-03-21,16,7877,591,3669,441,275,19,12872
2021-03-21,17,7871,553,4318,1031,178,18,13969
2021-03-21,18,7878,574,4464,1206,67,19,14208
2021-03-21,19,7878,580,4717,1472,6,16,14669
2021-03-21,20,7873,580,4462,2050,0,3,14968
2021-03-21,21,7864,585,4180,2349,0,0,14978
2021-03-21,22,7860,312,3947,2906,0,0,15025
2021-03-21,23,7873,215,3374,2995,0,0,14457
2021-03-21,24,7873,215,3112,2837,0,0,14037
2021-03-22,1,7872,215,2974,2797,0,10,13868
2021-03-22,2,7873,230,2889,2813,0,17,13822
2021-03-22,3,7870,235,2966,2582,0,17,13670
2021-03-22,4,7875,220,2936,2672,0,18,13721
2021-03-22,5,7876,196,3082,2612,0,22,13788
2021-03-22,6,7878,211,3535,2676,2,27,14329
2021-03-22,7,7877,261,3788,2902,10,31,14869
2021-03-22,8,7888,400,3633,2853,74,59,14907
2021-03-22,9,7886,393,3890,2285,169,57,14680
2021-03-22,10,7886,438,4134,2037,269,59,14823
2021-03-22,11,7893,394,3866,1918,317,63,14451
2021-03-22,12,7888,394,3765,1837,304,63,14251
2021-03-22,13,7896,452,3293,1751,300,60,13752
2021-03-22,14,7893,381,3313,1574,298,40,13499
2021-03-22,15,7890,459,3409,1741,286,38,13823
2021-03-22,16,7892,722,3486,1534,238,65,13937
2021-03-22,17,7895,691,3702,1629,146,87,14150
2021-03-22,18,7896,689,4149,1623,51,86,14494
2021-03-22,19,7890,735,4707,1394,5,89,14820
2021-03-22,20,7896,963,5043,1444,0,109,15455
2021-03-22,21,7888,755,4642,1681,0,85,15051
2021-03-22,22,7868,369,3977,1884,0,85,14183
2021-03-22,23,7880,202,3563,2012,0,75,13732
2021-03-22,24,7883,214,3504,1950,0,27,13578
2021-03-23,1,7884,290,3310,1996,0,14,13494
2021-03-23,2,7896,289,3067,1714,0,14,12980
2021-03-23,3,7893,317,3049,1761,0,14,13034
2021-03-23,4,7892,391,2943,1884,0,16,13126
2021-03-23,5,7855,726,3217,1398,0,19,13215
2021-03-23,6,7804,865,3520,1548,2,27,13766
2021-03-23,7,7800,983,3943,1775,10,31,14542
2021-03-23,8,7801,980,3842,1834,66,31,14554
2021-03-23,9,7801,980,3986,1224,150,31,14172
2021-03-23,10,7807,1050,4044,843,208,31,13983
2021-03-23,11,7900,738,4022,683,247,31,13621
2021-03-23,12,7900,857,3803,675,251,32,13518
2021-03-23,13,7896,739,3519,826,254,32,13266
2021-03-23,14,7898,594,3607,950,233,32,13314
2021-03-23,15,7846,633,3593,1134,176,32,13414
2021-03-23,16,7895,758,3573,1288,150,37,13701
2021-03-23,17,7891,863,4109,1308,105,76,14352
2021-03-23,18,7893,834,4276,1439,32,89,14563
2021-03-23,19,7893,794,4645,1556,3,88,14979
2021-03-23,20,7886,529,4676,2030,0,87,15208
2021-03-23,21,7889,466,4354,2062,0,87,14858
2021-03-23,22,7873,379,3962,2449,0,48,14711
2021-03-23,23,7886,275,3578,2604,0,21,14364
2021-03-23,24,7888,277,3276,2734,0,15,14190
2021-03-24,1,7884,277,2809,2801,0,14,13785
2021-03-24,2,7885,275,2691,2702,0,14,13567
2021-03-24,3,7888,274,2806,2608,0,15,13591
2021-03-24,4,7886,276,2699,2816,0,17,13694
2021-03-24,5,7888,269,2735,2741,0,25,13658
2021-03-24,6,7889,245,3220,2798,2,36,14190
2021-03-24,7,7887,264,3846,3247,4,40,15288
2021-03-24,8,7884,270,3964,3382,31,40,15571
2021-03-24,9,7883,268,4031,3392,136,39,15749
2021-03-24,10,7881,268,4026,2990,207,39,15411
2021-03-24,11,7882,268,3993,3008,225,39,15415
2021-03-24,12,7878,258,3916,3247,209,37,15545
2021-03-24,13,7878,256,3874,3250,213,33,15504
2021-03-24,14,7881,257,3836,3133,203,35,15345
2021-03-24,15,7874,266,4265,3059,166,34,15664
2021-03-24,16,7873,262,4371,3036,82,41,15665
2021-03-24,17,7870,262,4957,2945,86,40,16160
2021-03-24,18,7876,260,4998,2873,34,35,16076
2021-03-24,19,7876,257,4908,3111,4,32,16188
2021-03-24,20,7878,258,4505,3167,0,31,15839
2021-03-24,21,7930,256,4198,3006,0,31,15421
2021-03-24,22,7891,257,3545,3384,0,31,15108
2021-03-24,23,7940,255,3276,2947,0,21,14439
2021-03-24,24,7885,255,3144,2372,0,15,13671
2021-03-25,1,8099,255,2866,1959,0,15,13194
2021-03-25,2,8109,256,2844,1716,0,15,12940
2021-03-25,3,8106,255,2772,1640,0,15,12788
2021-03-25,4,8080,255,2782,1772,0,16,12905
2021-03-25,5,8059,255,2980,1796,0,19,13109
2021-03-25,6,8061,258,3612,1852,2,27,13812
2021-03-25,7,8064,261,3775,2530,9,33,14672
2021-03-25,8,8065,328,3639,2479,68,31,14610
2021-03-25,9,8071,371,4112,1597,153,31,14335
2021-03-25,10,8213,437,3941,1161,213,31,13996
2021-03-25,11,8269,490,3625,1164,257,31,13836
2021-03-25,12,8281,572,3543,1031,292,31,13750
2021-03-25,13,8276,771,3451,878,295,31,13702
2021-03-25,14,8383,904,3564,275,271,33,13430
2021-03-25,15,8441,1158,3592,244,217,35,13687
2021-03-25,16,8442,1159,4035,299,130,58,14123
2021-03-25,17,8440,1409,4477,218,63,96,14703
2021-03-25,18,8447,1495,4450,409,21,155,14977
2021-03-25,19,8457,1160,4524,881,2,117,15141
2021-03-25,20,8460,1136,4495,1040,0,85,15216
2021-03-25,21,7929,891,4388,1147,0,85,14440
2021-03-25,22,7620,359,4558,1427,0,42,14006
2021-03-25,23,7630,213,4193,1581,0,17,13634
2021-03-25,24,7646,211,3796,1826,0,16,13495
2021-03-26,1,7764,243,3343,2122,0,16,13488
2021-03-26,2,7778,213,3158,2200,0,14,13363
2021-03-26,3,7781,217,3133,2421,0,14,13566
2021-03-26,4,7776,249,3119,2676,0,15,13835
2021-03-26,5,7770,285,3330,2795,0,18,14198
2021-03-26,6,7779,269,3643,2894,2,28,14615
2021-03-26,7,7780,241,4018,3297,3,31,15370
2021-03-26,8,7774,235,3969,3316,12,31,15337
2021-03-26,9,7765,244,4034,3765,53,31,15892
2021-03-26,10,7737,422,4538,3836,76,31,16640
2021-03-26,11,7728,512,4172,3758,79,31,16280
2021-03-26,12,7721,524,3826,3300,119,31,15521
2021-03-26,13,7728,555,3893,2664,183,31,15054
2021-03-26,14,7735,970,3970,1791,201,32,14699
2021-03-26,15,7734,1079,4202,1655,129,60,14859
2021-03-26,16,7731,1148,4310,1328,114,88,14719
2021-03-26,17,7729,1387,4705,1175,56,157,15209
2021-03-26,18,7730,1243,4936,927,24,145,15005
2021-03-26,19,7812,1211,4817,862,2,86,14790
2021-03-26,20,7824,1217,4793,931,0,85,14850
2021-03-26,21,7822,979,5053,617,0,82,14553
2021-03-26,22,7823,460,5189,360,0,39,13871
2021-03-26,23,7828,304,4714,363,0,21,13230
2021-03-26,24,7830,262,4250,322,0,1,12665
2021-03-27,1,7825,264,4281,224,0,0,12594
2021-03-27,2,7831,267,4001,237,0,0,12336
2021-03-27,3,7835,286,4043,259,0,0,12423
2021-03-27,4,7834,334,3931,298,0,0,12397
2021-03-27,5,7828,472,3666,271,0,0,12237
2021-03-27,6,7769,454,3807,284,2,0,12316
2021-03-27,7,7764,469,4553,261,5,0,13052
2021-03-27,8,7760,710,5449,123,38,0,14080
2021-03-27,9,7755,847,5326,56,88,0,14072
2021-03-27,10,7755,790,5023,18,130,0,13716
2021-03-27,11,7750,645,5045,30,163,1,13634
2021-03-27,12,7748,533,4783,121,220,1,13406
2021-03-27,13,7744,453,4411,226,220,0,13054
2021-03-27,14,7776,451,4084,349,244,1,12905
2021-03-27,15,7804,451,4159,227,258,21,12920
2021-03-27,16,7808,449,4584,129,249,48,13267
2021-03-27,17,7807,468,5021,85,181,69,13631
2021-03-27,18,7807,454,5180,113,63,54,13671
2021-03-27,19,7807,443,5117,282,5,54,13708
2021-03-27,20,7805,441,4864,704,0,55,13869
2021-03-27,21,7808,438,4568,989,0,55,13858
2021-03-27,22,7779,278,4429,1326,0,55,13867
2021-03-27,23,7803,260,3966,1554,0,52,13635
2021-03-27,24,7807,260,3932,1575,0,11,13585
2021-03-28,1,7810,260,3570,1347,0,0,12987
2021-03-28,2,7811,260,3343,1220,0,0,12634
2021-03-28,3,7811,259,3336,1093,0,0,12499
2021-03-28,4,7808,259,3609,1121,0,0,12797
2021-03-28,5,7806,259,3656,1051,0,0,12772
2021-03-28,6,7800,259,3800,1148,2,0,13009
2021-03-28,7,7800,234,4201,1653,2,0,13890
2021-03-28,8,7805,231,4492,1652,15,0,14195
2021-03-28,9,7426,267,5304,1752,29,0,14778
2021-03-28,10,7015,623,5561,2572,40,0,15811
2021-03-28,11,7017,563,4344,2911,69,0,14904
2021-03-28,12,7014,332,4331,3229,52,0,14958
2021-03-28,13,7018,231,4459,3578,64,0,15350
2021-03-28,14,7013,232,4101,3994,86,0,15426
2021-03-28,15,7008,231,4028,4312,122,0,15701
2021-03-28,16,7011,231,4241,4453,101,0,16037
2021-03-28,17,7004,231,4687,4480,44,0,16446
2021-03-28,18,7007,249,4176,4461,22,0,15915
2021-03-28,19,7001,259,4464,4379,0,1,16104
2021-03-28,20,7003,260,4449,4294,0,3,16009
2021-03-28,21,7004,261,4303,4260,0,0,15828
2021-03-28,22,7006,263,4062,3955,0,0,15286
2021-03-28,23,6999,269,3585,3725,0,0,14578
2021-03-28,24,7001,352,3581,3176,0,0,14110
2021-03-29,1,7001,434,3493,2993,0,1,13922
2021-03-29,2,7004,447,3338,2803,0,11,13603
2021-03-29,3,7002,478,3352,2740,0,15,13587
2021-03-29,4,7001,664,3335,2872,0,16,13888
2021-03-29,5,6998,937,3797,2511,0,23,14266
2021-03-29,6,6999,1232,4352,2072,2,39,14696
2021-03-29,7,6999,1759,4991,1488,7,71,15315
2021-03-29,8,7000,1787,4812,1175,74,141,14989
2021-03-29,9,6995,1402,4230,1060,191,131,14009
2021-03-29,10,6999,1396,4187,951,301,101,13935
2021-03-29,11,6998,1502,4453,802,339,108,14202
2021-03-29,12,6998,1527,4441,897,354,130,14347
2021-03-29,13,6995,1421,3888,1049,379,95,13827
2021-03-29,14,6987,1319,3797,962,406,92,13563
2021-03-29,15,6980,1393,3881,615,412,91,13372
2021-03-29,16,6982,1485,3984,690,369,91,13601
2021-03-29,17,6986,1551,4032,1309,233,92,14203
2021-03-29,18,6990,1582,4208,1626,85,93,14584
2021-03-29,19,6990,1561,4756,1716,8,93,15124
2021-03-29,20,6990,1534,4874,2493,0,92,15983
2021-03-29,21,6983,793,4523,2788,0,92,15179
2021-03-29,22,6974,501,4276,3059,0,44,14854
2021-03-29,23,6973,424,4101,3149,0,24,14671
2021-03-29,24,6986,315,3702,3475,0,18,14496
2021-03-30,1,6987,266,3345,3765,0,18,14381
2021-03-30,2,6983,266,3311,3276,0,17,13853
2021-03-30,3,6971,266,3244,3691,0,16,14188
2021-03-30,4,6984,266,3245,3638,0,17,14150
2021-03-30,5,6981,332,3542,3563,0,24,14442
2021-03-30,6,6983,412,3601,4024,2,31,15053
2021-03-30,7,6981,508,4254,4376,21,40,16180
2021-03-30,8,6977,532,4239,4038,124,44,15954
2021-03-30,9,6978,531,4414,3604,272,39,15838
2021-03-30,10,6989,522,4438,3169,386,41,15545
2021-03-30,11,6983,505,4182,3399,409,38,15516
2021-03-30,12,6979,506,4096,3287,421,33,15322
2021-03-30,13,6977,347,4129,3368,401,32,15254
2021-03-30,14,6976,276,4088,3372,388,31,15131
2021-03-30,15,6976,350,3956,3465,346,31,15124
2021-03-30,16,6977,423,4076,3700,266,31,15473
2021-03-30,17,6970,494,4316,4110,143,31,16064
2021-03-30,18,7066,488,4668,3868,61,31,16182
2021-03-30,19,7201,490,4736,4101,4,31,16563
2021-03-30,20,7260,484,4676,4200,0,31,16651
2021-03-30,21,7413,486,4656,3646,0,31,16232
2021-03-30,22,7399,487,4508,2972,0,31,15397
2021-03-30,23,7365,357,4131,2386,0,26,14265
2021-03-30,24,7369,268,3839,1976,0,16,13468
2021-03-31,1,7422,269,3275,2107,0,15,13088
2021-03-31,2,7536,343,3260,1774,0,15,12928
2021-03-31,3,7542,384,3242,1638,0,15,12821
2021-03-31,4,7542,442,3319,1554,0,14,12871
2021-03-31,5,7542,584,3545,1919,0,18,13608
2021-03-31,6,7537,617,3797,2484,1,27,14463
2021-03-31,7,7536,656,4642,1934,3,37,14808
2021-03-31,8,7531,910,4953,1584,18,47,15043
2021-03-31,9,7529,982,4208,1666,53,47,14485
2021-03-31,10,7527,846,3870,1608,84,48,13983
2021-03-31,11,7534,591,3986,1808,117,43,14079
2021-03-31,12,7531,617,4213,1923,115,31,14430
2021-03-31,13,7534,535,4030,1905,150,30,14184
2021-03-31,14,7531,465,4000,1777,181,30,13984
2021-03-31,15,7532,483,3814,1859,175,30,13893
2021-03-31,16,7534,525,4028,1935,153,30,14205
2021-03-31,17,7535,662,4319,1920,94,30,14560
2021-03-31,18,7535,696,4359,1815,39,30,14474
2021-03-31,19,7535,658,4528,1964,3,30,14718
2021-03-31,20,7531,629,5197,2181,0,30,15568
2021-03-31,21,7542,617,5002,2176,0,30,15367
2021-03-31,22,7637,450,4799,2151,0,30,15067
2021-03-31,23,7647,405,4284,2038,0,22,14396
2021-03-31,24,7645,233,4119,2103,0,17,14117
2021-04-01,1,7638,227,3444,2506,0,14,13829
2021-04-01,2,7642,228,2970,2998,0,15,13853
2021-04-01,3,7645,229,3099,3077,0,15,14065
2021-04-01,4,7681,314,3023,3042,0,15,14075
2021-04-01,5,7689,332,3133,2974,0,19,14147
2021-04-01,6,7691,375,3840,2712,2,27,14647
2021-04-01,7,7687,437,4270,2703,8,30,15135
2021-04-01,8,7683,428,4247,3161,57,30,15606
2021-04-01,9,7684,429,4160,3477,138,30,15918
2021-04-01,10,7682,431,4111,3199,209,30,15662
2021-04-01,11,7682,430,4206,3350,195,30,15893
2021-04-01,12,7678,429,3887,2870,216,31,15111
2021-04-01,13,7679,286,3832,2547,148,31,14523
2021-04-01,14,7694,211,3738,2928,192,31,14794
2021-04-01,15,7706,309,3735,3229,170,31,15180
2021-04-01,16,7691,486,3911,2649,194,31,14962
2021-04-01,17,7837,727,4084,3265,184,31,16128
2021-04-01,18,7924,868,4206,2732,83,30,15843
2021-04-01,19,7933,873,4449,2916,8,30,16209
2021-04-01,20,7925,873,4710,3533,0,30,17071
2021-04-01,21,7928,874,4806,3254,0,30,16892
2021-04-01,22,7940,871,4967,2725,0,30,16533
2021-04-01,23,7946,599,4950,2490,0,14,15999
2021-04-01,24,7955,187,4513,2355,0,0,15010
2021-04-02,1,7953,123,3980,2253,0,0,14309
2021-04-02,2,7947,122,3746,2221,0,0,14036
2021-04-02,3,7970,120,3800,2253,0,0,14143
2021-04-02,4,7979,120,3432,2237,0,0,13768
2021-04-02,5,8108,121,3814,2087,0,0,14130
2021-04-02,6,8295,123,4482,1901,2,0,14803
2021-04-02,7,8444,125,5059,1549,26,0,15203
2021-04-02,8,8435,124,4906,1163,153,0,14781
2021-04-02,9,8443,124,4586,1370,312,0,14835
2021-04-02,10,8444,123,4393,1261,413,0,14634
2021-04-02,11,8455,123,4580,1132,432,0,14722
2021-04-02,12,8448,125,4321,1640,433,0,14967
2021-04-02,13,8451,231,4028,1302,433,0,14445
2021-04-02,14,8460,281,3891,1110,399,0,14141
2021-04-02,15,8474,343,3902,852,331,0,13902
2021-04-02,16,8474,344,3983,897,299,0,13997
2021-04-02,17,8482,345,4882,987,198,0,14894
2021-04-02,18,8570,358,5350,748,78,0,15104
2021-04-02,19,8585,348,5425,598,9,4,14969
2021-04-02,20,8583,390,6002,598,0,2,15575
2021-04-02,21,8585,217,5401,599,0,0,14802
2021-04-02,22,8580,124,4803,570,0,0,14077
2021-04-02,23,8577,123,4442,700,0,0,13842
2021-04-02,24,8581,123,4090,1002,0,0,13796
2021-04-03,1,8592,123,3460,1216,0,0,13391
2021-04-03,2,8591,124,3381,1477,0,0,13573
2021-04-03,3,8591,123,3398,1579,0,0,13691
2021-04-03,4,8600,123,3294,1617,0,0,13634
2021-04-03,5,8629,123,3512,1674,0,0,13938
2021-04-03,6,8634,123,3565,1942,2,0,14266
2021-04-03,7,8640,124,3684,1912,20,0,14380
2021-04-03,8,8640,123,3926,1980,80,0,14749
2021-04-03,9,8638,124,3924,2029,124,0,14839
2021-04-03,10,8638,123,3784,2188,231,0,14964
2021-04-03,11,8631,123,3583,2075,314,0,14726
2021-04-03,12,8636,124,3400,2107,353,0,14620
2021-04-03,13,8636,124,3345,2119,333,0,14557
2021-04-03,14,8633,124,3316,1888,300,0,14261
2021-04-03,15,8636,124,3428,2090,238,0,14516
2021-04-03,16,8638,126,3686,2738,155,0,15343
2021-04-03,17,8643,126,4447,2666,84,0,15966
2021-04-03,18,8644,125,5027,1988,46,0,15830
2021-04-03,19,8645,126,5456,1574,7,0,15808
2021-04-03,20,8649,124,4900,1760,0,0,15433
2021-04-03,21,8640,124,4723,1830,0,0,15317
2021-04-03,22,8638,124,4701,1723,0,0,15186
2021-04-03,23,8640,125,4623,1054,0,0,14442
2021-04-03,24,8640,142,4301,899,0,0,13982
2021-04-04,1,8640,128,3246,1042,0,0,13056
2021-04-04,2,8659,125,3086,1041,0,0,12911
2021-04-04,3,8662,124,3170,1247,0,0,13203
2021-04-04,4,8662,124,3087,1290,0,0,13163
2021-04-04,5,8660,123,3403,1077,0,0,13263
2021-04-04,6,8668,124,4089,877,2,0,13760
2021-04-04,7,8670,124,4301,784,28,0,13907
2021-04-04,8,8671,123,4365,616,122,0,13897
2021-04-04,9,8665,124,4530,226,271,0,13816
2021-04-04,10,8675,124,4358,136,388,0,13681
2021-04-04,11,8683,124,4224,81,421,1,13534
2021-04-04,12,8684,124,4081,92,432,2,13415
2021-04-04,13,8683,123,3788,186,432,0,13212
2021-04-04,14,8684,122,3622,212,419,0,13059
2021-04-04,15,8685,123,3748,393,372,0,13321
2021-04-04,16,8681,123,4029,538,332,0,13703
2021-04-04,17,8684,123,4665,528,212,0,14212
2021-04-04,18,8684,124,5154,474,87,0,14523
2021-04-04,19,8681,122,4955,482,10,0,14250
2021-04-04,20,8685,123,5381,542,0,0,14731
2021-04-04,21,8686,123,5529,497,0,0,14835
2021-04-04,22,8683,122,5232,472,0,0,14509
2021-04-04,23,8685,122,4534,488,0,1,13830
2021-04-04,24,8684,123,3947,626,0,0,13380
2021-04-05,1,8681,148,3377,713,0,0,12919
2021-04-05,2,8684,152,3237,1090,0,4,13167
2021-04-05,3,8689,154,2973,1246,0,11,13073
2021-04-05,4,8692,171,2918,1335,0,15,13131
2021-04-05,5,8693,181,2945,1031,0,17,12867
2021-04-05,6,8688,202,3595,1475,2,25,13987
2021-04-05,7,8687,205,4020,1936,28,29,14905
2021-04-05,8,8683,206,4578,1700,124,29,15320
2021-04-05,9,8687,265,4816,1392,248,29,15437
2021-04-05,10,8696,312,4887,1243,324,30,15492
2021-04-05,11,8710,310,4642,939,336,30,14967
2021-04-05,12,8719,313,4968,691,301,30,15022
2021-04-05,13,8735,352,4727,924,277,29,15044
2021-04-05,14,8759,477,4173,1190,296,30,14925
2021-04-05,15,8783,547,4056,1120,265,31,14802
2021-04-05,16,8790,551,4355,1607,215,30,15548
2021-04-05,17,8821,553,4723,1864,134,31,16126
2021-04-05,18,8836,555,4864,1742,53,31,16081
2021-04-05,19,8835,558,4735,1596,7,31,15762
2021-04-05,20,8833,457,4685,1538,0,35,15548
2021-04-05,21,8860,375,4725,1552,0,35,15547
2021-04-05,22,8881,271,4586,1390,0,32,15160
2021-04-05,23,8922,208,3898,1522,0,23,14573
2021-04-05,24,8944,210,3304,1742,0,20,14220
2021-04-06,1,8937,212,3062,1629,0,15,13855
2021-04-06,2,8944,209,3026,1601,0,15,13795
2021-04-06,3,8940,276,2891,1685,0,15,13807
2021-04-06,4,8942,365,2958,1445,0,16,13726
2021-04-06,5,8943,428,3215,1190,0,18,13794
2021-04-06,6,8950,430,3948,1740,2,26,15096
2021-04-06,7,8951,430,4571,1575,33,33,15593
2021-04-06,8,8954,429,4629,1232,127,40,15411
2021-04-06,9,8954,427,4498,1664,225,35,15803
2021-04-06,10,8956,427,4538,1463,305,40,15729
2021-04-06,11,8965,281,4303,1186,366,38,15139
2021-04-06,12,8961,205,3875,1219,370,46,14676
2021-04-06,13,8948,205,4073,1128,380,44,14778
2021-04-06,14,8938,206,3865,1074,370,32,14485
2021-04-06,15,8942,207,4274,935,320,31,14709
2021-04-06,16,8944,206,4275,1039,211,31,14706
2021-04-06,17,9022,275,4951,1042,125,31,15446
2021-04-06,18,9052,361,5009,962,62,31,15477
2021-04-06,19,9065,430,5112,1045,8,34,15694
2021-04-06,20,9062,434,5148,1289,0,35,15968
2021-04-06,21,9059,431,4863,1312,0,31,15696
2021-04-06,22,9044,430,4851,1121,0,31,15477
2021-04-06,23,9049,429,4570,795,0,22,14865
2021-04-06,24,9050,426,3817,1102,0,15,14410
2021-04-07,1,9045,291,3234,1014,0,15,13599
2021-04-07,2,9056,207,3344,893,0,15,13515
2021-04-07,3,9056,207,3136,868,0,16,13283
2021-04-07,4,9061,208,3413,796,0,18,13496
2021-04-07,5,9063,206,3275,832,0,20,13396
2021-04-07,6,9065,208,3617,859,2,25,13776
2021-04-07,7,9060,209,4227,1100,16,30,14642
2021-04-07,8,9058,209,4817,833,80,30,15027
2021-04-07,9,9058,270,5056,553,176,30,15143
2021-04-07,10,9059,278,4665,424,326,30,14782
2021-04-07,11,9065,205,4324,466,378,31,14469
2021-04-07,12,9060,205,3926,407,392,30,14020
2021-04-07,13,9060,204,3811,374,390,30,13869
2021-04-07,14,9068,203,3858,412,395,30,13966
2021-04-07,15,9114,204,3836,560,381,30,14125
2021-04-07,16,9121,203,4026,433,284,30,14097
2021-04-07,17,9120,203,4059,1283,190,30,14885
2021-04-07,18,9122,205,4217,1108,73,31,14756
2021-04-07,19,9120,204,4057,1413,10,31,14835
2021-04-07,20,9118,207,4053,2374,0,31,15783
2021-04-07,21,9138,207,4029,2395,0,31,15800
2021-04-07,22,9169,208,3143,2457,0,31,15008
2021-04-07,23,9174,208,3095,1528,0,21,14026
2021-04-07,24,9177,208,2942,1508,0,16,13851
2021-04-08,1,9183,208,2881,1077,0,15,13364
2021-04-08,2,9182,207,2851,860,0,15,13115
2021-04-08,3,9174,206,2918,785,0,15,13098
2021-04-08,4,9182,206,2958,893,0,16,13255
2021-04-08,5,9179,206,2921,1189,1,19,13515
2021-04-08,6,9175,205,3083,2018,2,25,14508
2021-04-08,7,9177,205,3887,1859,28,30,15186
2021-04-08,8,9180,204,4154,1798,128,31,15495
2021-04-08,9,9182,204,3985,1752,244,30,15397
2021-04-08,10,9182,200,3732,1651,328,31,15124
2021-04-08,11,9174,198,3691,1708,393,30,15194
2021-04-08,12,9178,197,3380,1921,376,31,15083
2021-04-08,13,9182,196,3277,1876,368,31,14930
2021-04-08,14,9182,194,3240,1827,373,31,14847
2021-04-08,15,9186,194,3148,2088,363,31,15010
2021-04-08,16,9178,193,3287,2059,281,31,15029
2021-04-08,17,9181,192,3744,2543,168,31,15859
2021-04-08,18,9189,194,4332,2181,56,31,15983
2021-04-08,19,9187,202,4124,1935,8,31,15487
2021-04-08,20,9188,196,4226,1928,0,31,15569
2021-04-08,21,9186,198,3942,2141,0,32,15499
2021-04-08,22,9184,201,3937,1833,0,32,15187
2021-04-08,23,9183,201,3619,1459,0,22,14484
2021-04-08,24,9189,200,3101,991,0,17,13498
2021-04-09,1,9196,200,2884,1198,0,16,13494
2021-04-09,2,9197,197,2831,941,0,15,13181
2021-04-09,3,9194,202,2734,801,0,16,12947
2021-04-09,4,9201,212,2729,783,0,17,12942
2021-04-09,5,9190,214,2831,1098,0,23,13356
2021-04-09,6,9189,227,2855,1931,1,28,14231
2021-04-09,7,9188,203,3622,1770,22,32,14837
2021-04-09,8,9182,200,3961,2311,84,31,15769
2021-04-09,9,9184,196,4032,2151,179,31,15773
2021-04-09,10,9183,193,4242,1991,199,31,15839
2021-04-09,11,9186,193,4203,2015,216,31,15844
2021-04-09,12,9188,193,3892,2182,275,30,15760
2021-04-09,13,9195,193,3812,2214,234,31,15679
2021-04-09,14,9191,192,3490,2317,261,31,15482
2021-04-09,15,9188,193,3176,2517,257,30,15361
2021-04-09,16,9132,196,3535,2399,203,30,15495
2021-04-09,17,9134,197,3925,2538,147,34,15975
2021-04-09,18,9132,197,3916,2740,77,57,16119
2021-04-09,19,9136,194,3974,2851,16,81,16252
2021-04-09,20,9132,195,3916,3040,0,81,16364
2021-04-09,21,9127,195,3754,2754,0,80,15910
2021-04-09,22,9125,195,3365,2729,0,81,15495
2021-04-09,23,9124,146,3063,2139,0,64,14536
2021-04-09,24,9128,141,2832,1746,0,15,13862
2021-04-10,1,9130,140,2714,1495,0,0,13479
2021-04-10,2,9141,140,2754,1143,0,2,13180
2021-04-10,3,9144,140,2630,1024,0,1,12939
2021-04-10,4,9144,140,2683,952,0,0,12919
2021-04-10,5,9145,140,2837,982,1,0,13105
2021-04-10,6,9151,139,3280,1074,2,0,13646
2021-04-10,7,9149,140,3632,935,29,1,13886
2021-04-10,8,9146,140,3772,715,122,8,13903
2021-04-10,9,9140,140,3677,563,245,40,13805
2021-04-10,10,9137,140,3786,434,320,55,13872
2021-04-10,11,9132,139,3702,369,368,54,13764
2021-04-10,12,9131,140,3571,233,377,56,13508
2021-04-10,13,9134,140,3444,214,389,56,13377
2021-04-10,14,9132,140,3316,143,350,56,13137
2021-04-10,15,9135,139,3505,508,287,56,13630
2021-04-10,16,9136,140,3669,984,194,56,14179
2021-04-10,17,9131,139,3605,1296,124,54,14349
2021-04-10,18,9135,139,3909,1521,49,54,14807
2021-04-10,19,9124,141,3958,1837,8,56,15124
2021-04-10,20,9121,141,3822,1830,0,56,14970
2021-04-10,21,9127,142,3645,2042,0,56,15012
2021-04-10,22,9118,142,3486,1951,0,55,14752
2021-04-10,23,9119,141,2874,1768,0,12,13914
2021-04-10,24,9119,142,2763,1296,0,0,13320
2021-04-11,1,9120,141,2732,763,0,0,12756
2021-04-11,2,9116,141,2712,617,0,0,12586
2021-04-11,3,9113,141,2677,475,0,0,12406
2021-04-11,4,9117,141,2639,448,0,0,12345
2021-04-11,5,9121,141,2772,615,0,0,12649
2021-04-11,6,9120,142,2976,688,1,0,12927
2021-04-11,7,9117,153,3108,883,17,0,13278
2021-04-11,8,9110,161,3360,916,70,0,13617
2021-04-11,9,9108,150,3562,1241,119,0,14180
2021-04-11,10,9099,146,4260,908,152,0,14565
2021-04-11,11,9098,146,3943,776,248,0,14211
2021-04-11,12,9104,145,3625,706,247,0,13827
2021-04-11,13,9109,145,3600,718,168,0,13740
2021-04-11,14,9113,145,3308,882,137,2,13587
2021-04-11,15,9112,145,3395,1232,136,29,14049
2021-04-11,16,9111,145,4290,1329,74,66,15015
2021-04-11,17,9106,145,5102,1113,51,127,15644
2021-04-11,18,9110,146,5314,804,36,172,15582
2021-04-11,19,9109,146,4653,849,6,83,14846
2021-04-11,20,9097,146,4151,727,0,51,14172
2021-04-11,21,9106,152,4107,585,0,51,14001
2021-04-11,22,9114,156,3847,807,0,18,13942
2021-04-11,23,9097,156,3215,790,0,0,13258
2021-04-11,24,9089,157,3188,765,0,0,13199
2021-04-12,1,9095,157,2995,690,0,0,12937
2021-04-12,2,9095,157,3119,502,0,3,12876
2021-04-12,3,9116,158,3193,435,0,12,12914
2021-04-12,4,9110,156,3097,485,0,14,12862
2021-04-12,5,9108,165,2927,306,0,26,12532
2021-04-12,6,9106,193,3320,323,1,64,13007
2021-04-12,7,9098,213,4034,383,7,77,13812
2021-04-12,8,9092,212,4523,362,36,78,14303
2021-04-12,9,9087,223,5027,448,80,129,14994
2021-04-12,10,9091,363,5321,467,102,213,15557
2021-04-12,11,9093,652,4779,479,151,190,15344
2021-04-12,12,9098,739,4490,384,171,169,15051
2021-04-12,13,9097,688,4607,296,180,171,15039
2021-04-12,14,9094,736,4493,356,259,167,15105
2021-04-12,15,9103,868,4548,472,240,151,15382
2021-04-12,16,9107,915,4462,637,194,93,15408
2021-04-12,17,9102,919,4840,665,96,82,15704
2021-04-12,18,9097,917,4975,609,34,108,15740
2021-04-12,19,9091,916,5239,397,5,134,15782
2021-04-12,20,9097,915,4999,340,0,158,15509
2021-04-12,21,9095,747,4669,428,0,96,15035
2021-04-12,22,9093,441,4321,505,0,85,14445
2021-04-12,23,9091,245,4183,640,0,78,14237
2021-04-12,24,9094,210,3695,696,0,23,13718
2021-04-13,1,9097,210,3225,661,0,12,13205
2021-04-13,2,9104,210,3026,647,0,12,12999
2021-04-13,3,9105,210,3037,821,0,12,13185
2021-04-13,4,9109,209,3136,955,0,11,13420
2021-04-13,5,9107,209,3193,780,0,21,13310
2021-04-13,6,9109,210,3825,887,1,62,14094
2021-04-13,7,9106,210,4741,629,16,82,14784
2021-04-13,8,9103,210,5247,427,58,140,15185
2021-04-13,9,9107,209,4898,386,111,163,14874
2021-04-13,10,9101,209,4814,351,192,90,14757
2021-04-13,11,9113,211,4805,324,263,102,14818
2021-04-13,12,9115,211,4519,519,332,101,14797
2021-04-13,13,9112,212,4087,508,360,80,14359
2021-04-13,14,9124,213,4019,696,360,82,14494
2021-04-13,15,9118,270,3904,865,341,85,14583
2021-04-13,16,9116,350,4019,949,313,85,14832
2021-04-13,17,9120,427,4443,858,199,83,15130
2021-04-13,18,9113,429,4616,884,80,83,15205
2021-04-13,19,9107,404,4903,783,12,83,15292
2021-04-13,20,9111,419,4903,828,0,84,15345
2021-04-13,21,9107,418,4719,829,0,85,15158
2021-04-13,22,9107,419,4706,633,0,90,14955
2021-04-13,23,9117,255,3875,740,1,72,14060
2021-04-13,24,9135,213,3278,1274,1,31,13932
2021-04-14,1,9145,213,3325,794,0,16,13493
2021-04-14,2,9139,214,3365,841,0,15,13574
2021-04-14,3,9135,214,3098,922,0,16,13385
2021-04-14,4,9130,214,3370,695,0,18,13427
2021-04-14,5,9136,215,3646,645,0,42,13684
2021-04-14,6,9143,215,3903,543,2,75,13881
2021-04-14,7,9144,216,4424,330,35,84,14233
2021-04-14,8,9148,216,4986,142,143,84,14719
2021-04-14,9,9145,216,4983,84,258,86,14772
2021-04-14,10,9148,215,4807,204,355,84,14813
2021-04-14,11,9159,215,4627,466,370,84,14921
2021-04-14,12,9159,216,4356,928,385,84,15128
2021-04-14,13,9156,216,4070,1008,394,84,14928
2021-04-14,14,9157,276,4133,758,379,84,14787
2021-04-14,15,9155,340,4007,865,347,85,14799
2021-04-14,16,9153,416,4124,820,284,84,14881
2021-04-14,17,9151,423,4816,1173,183,88,15834
2021-04-14,18,9153,425,4807,1162,74,85,15706
2021-04-14,19,9148,425,4716,1027,11,86,15413
2021-04-14,20,9145,427,4644,755,0,85,15056
2021-04-14,21,9142,427,4288,395,0,83,14335
2021-04-14,22,9154,256,4039,574,0,83,14106
2021-04-14,23,9157,215,3738,650,0,37,13797
2021-04-14,24,9158,215,3756,720,0,17,13866
2021-04-15,1,9154,213,3501,539,0,17,13424
2021-04-15,2,9158,213,3383,438,0,17,13209
2021-04-15,3,9157,212,3390,480,0,17,13256
2021-04-15,4,9157,212,3224,551,0,17,13161
2021-04-15,5,9163,214,3399,400,1,37,13214
2021-04-15,6,9165,213,3632,287,2,72,13371
2021-04-15,7,9163,215,4614,543,15,84,14634
2021-04-15,8,9161,233,5232,689,66,132,15513
2021-04-15,9,9157,239,5417,803,75,213,15904
2021-04-15,10,9156,239,5329,843,71,224,15862
2021-04-15,11,9153,272,5048,825,139,219,15656
2021-04-15,12,9155,469,4988,829,169,222,15832
2021-04-15,13,9149,592,4439,905,156,170,15411
2021-04-15,14,9154,533,3961,985,161,88,14882
2021-04-15,15,9155,321,4261,1137,129,84,15087
2021-04-15,16,9150,404,4710,1139,104,115,15622
2021-04-15,17,9153,402,5191,1173,70,160,16149
2021-04-15,18,9160,384,5106,1091,31,88,15860
2021-04-15,19,9157,424,5382,1147,5,59,16174
2021-04-15,20,9149,467,5244,1154,0,90,16104
2021-04-15,21,9149,263,4704,1247,0,55,15418
2021-04-15,22,9152,216,4310,1458,0,56,15192
2021-04-15,23,9150,196,3802,1362,0,14,14524
2021-04-15,24,9146,206,3785,1230,0,0,14367
2021-04-16,1,9149,199,3234,1094,0,0,13676
2021-04-16,2,9151,192,2912,1326,0,0,13581
2021-04-16,3,9152,197,2906,1475,0,0,13730
2021-04-16,4,9156,217,2986,1372,0,0,13731
2021-04-16,5,9157,219,2877,1876,1,0,14130
2021-04-16,6,9152,217,3280,1945,2,11,14607
2021-04-16,7,9155,216,4087,2215,15,44,15732
2021-04-16,8,9148,218,4738,2120,45,54,16323
2021-04-16,9,9150,218,4790,2217,72,54,16501
2021-04-16,10,9149,221,4731,2049,160,54,16364
2021-04-16,11,9150,236,4601,2017,144,54,16202
2021-04-16,12,9145,294,4340,2070,144,54,16047
2021-04-16,13,9140,300,4166,2001,164,16,15787
2021-04-16,14,9142,364,4000,1923,185,0,15614
2021-04-16,15,9141,435,4008,1811,144,0,15539
2021-04-16,16,9140,427,4303,1684,124,0,15678
2021-04-16,17,9138,444,5119,1520,84,3,16308
2021-04-16,18,9143,461,5623,1225,34,38,16524
2021-04-16,19,9147,443,5322,1006,7,61,15986
2021-04-16,20,9145,442,5507,822,0,116,16032
2021-04-16,21,9147,444,5344,727,0,99,15761
2021-04-16,22,9146,272,5128,506,0,74,15126
2021-04-16,23,9148,221,4649,400,0,64,14482
2021-04-16,24,9148,218,3652,359,0,56,13433
2021-04-17,1,9152,220,3251,364,0,53,13040
2021-04-17,2,9161,221,3236,450,0,54,13122
2021-04-17,3,9155,221,3267,514,0,55,13212
2021-04-17,4,9149,220,3208,503,0,53,13133
2021-04-17,5,9145,242,3223,451,0,53,13114
2021-04-17,6,9149,232,3407,326,2,53,13169
2021-04-17,7,9149,232,4237,234,20,53,13925
2021-04-17,8,9157,233,5021,146,97,55,14709
2021-04-17,9,9157,233,5031,84,214,79,14798
2021-04-17,10,9159,233,4757,64,242,49,14504
2021-04-17,11,9161,232,4584,136,235,50,14398
2021-04-17,12,9158,231,4346,260,224,51,14270
2021-04-17,13,9161,231,4126,370,217,51,14156
2021-04-17,14,9158,231,3918,207,200,51,13765
2021-04-17,15,9162,231,4173,204,246,51,14067
2021-04-17,16,9157,230,4327,232,216,51,14213
2021-04-17,17,9152,230,4591,320,134,51,14478
2021-04-17,18,9159,230,4971,205,38,51,14654
2021-04-17,19,9154,230,4947,327,11,51,14720
2021-04-17,20,9151,231,5154,586,0,54,15176
2021-04-17,21,9157,232,4889,543,0,55,14876
2021-04-17,22,9152,257,4395,438,0,53,14295
2021-04-17,23,9140,239,4080,548,0,54,14061
2021-04-17,24,9152,234,3668,547,0,55,13656
2021-04-18,1,9152,231,3441,459,0,54,13337
2021-04-18,2,9150,234,3108,498,0,55,13045
2021-04-18,3,9154,234,2968,492,0,54,12902
2021-04-18,4,9150,233,2994,524,0,53,12954
2021-04-18,5,9150,233,3216,450,0,53,13102
2021-04-18,6,9149,234,3500,430,3,53,13369
2021-04-18,7,9146,234,3525,346,45,52,13348
2021-04-18,8,9144,234,3857,267,144,50,13696
2021-04-18,9,9141,233,3994,126,254,49,13797
2021-04-18,10,9144,233,3932,178,346,49,13882
2021-04-18,11,9139,232,3825,293,331,10,13830
2021-04-18,12,9136,231,3785,481,255,0,13888
2021-04-18,13,9139,230,3688,337,293,0,13687
2021-04-18,14,9146,230,3601,412,305,0,13694
2021-04-18,15,9141,229,3717,589,271,0,13947
2021-04-18,16,9147,229,4215,651,215,1,14458
2021-04-18,17,9141,229,5006,602,107,17,15102
2021-04-18,18,9144,230,5067,379,61,44,14925
2021-04-18,19,9143,230,5110,376,15,50,14924
2021-04-18,20,9138,231,4989,262,0,49,14669
2021-04-18,21,9139,231,4551,286,0,50,14257
2021-04-18,22,9139,235,4331,503,0,56,14264
2021-04-18,23,9141,233,3847,679,0,57,13957
2021-04-18,24,9144,233,3203,731,0,10,13321
2021-04-19,1,9138,232,3136,801,0,0,13307
2021-04-19,2,9146,232,3111,957,0,8,13454
2021-04-19,3,9143,232,3044,883,0,15,13317
2021-04-19,4,9138,232,2954,1401,0,16,13741
2021-04-19,5,9142,232,3174,1407,0,21,13976
2021-04-19,6,9142,233,3457,1428,3,31,14294
2021-04-19,7,9137,233,4092,1181,43,31,14717
2021-04-19,8,9139,241,4578,1199,150,31,15338
2021-04-19,9,9135,315,4663,1060,252,30,15455
2021-04-19,10,9139,339,4267,939,362,32,15078
2021-04-19,11,9134,339,4052,1269,399,32,15225
2021-04-19,12,9134,338,3581,1901,390,31,15375
2021-04-19,13,9131,340,3432,2294,377,32,15606
2021-04-19,14,9130,383,3089,2624,345,32,15603
2021-04-19,15,9130,463,3249,2759,270,32,15903
2021-04-19,16,9127,452,3556,3037,191,31,16394
2021-04-19,17,9118,453,3833,3288,119,32,16843
2021-04-19,18,9115,455,4160,3144,40,32,16946
2021-04-19,19,9118,438,4475,2832,7,32,16902
2021-04-19,20,9113,456,4608,2740,0,32,16949
2021-04-19,21,9111,325,4519,2354,0,32,16341
2021-04-19,22,9094,231,3981,2335,0,32,15673
2021-04-19,23,9104,231,3592,1905,0,20,14852
2021-04-19,24,9103,232,2851,2334,0,16,14536
2021-04-20,1,9100,239,2717,1814,0,16,13886
2021-04-20,2,9102,232,2585,1533,0,17,13469
2021-04-20,3,9106,232,2591,1460,0,18,13407
2021-04-20,4,9102,233,2649,1595,0,19,13598
2021-04-20,5,9105,234,2707,1663,2,19,13730
2021-04-20,6,9110,235,3026,1628,3,28,14030
2021-04-20,7,9107,236,3683,1717,29,32,14804
2021-04-20,8,9104,245,4474,2213,79,32,16147
2021-04-20,9,9102,242,4403,2327,139,32,16245
2021-04-20,10,9101,285,4306,2124,171,32,16019
2021-04-20,11,9105,290,4112,2386,207,32,16132
2021-04-20,12,9099,312,4782,2193,211,32,16629
2021-04-20,13,9100,346,4076,2212,206,32,15972
2021-04-20,14,9103,514,3916,1550,176,31,15290
2021-04-20,15,9103,638,4265,1550,122,34,15712
2021-04-20,16,9099,634,5111,1308,80,60,16292
2021-04-20,17,9097,718,5243,1043,46,117,16264
2021-04-20,18,9098,687,5189,898,24,163,16059
2021-04-20,19,9097,665,5008,812,4,106,15692
2021-04-20,20,9098,668,5282,600,0,90,15738
2021-04-20,21,9096,327,5003,536,0,89,15051
2021-04-20,22,9091,238,4747,595,0,91,14762
2021-04-20,23,9093,236,4238,508,0,84,14159
2021-04-20,24,9089,236,3749,544,0,74,13692
2021-04-21,1,9083,225,4007,606,0,74,13995
2021-04-21,2,9087,235,3779,763,0,74,13938
2021-04-21,3,9083,232,3616,1043,0,73,14047
2021-04-21,4,9074,287,3494,1181,0,74,14110
2021-04-21,5,9084,347,3346,992,0,75,13844
2021-04-21,6,9083,437,3600,1138,0,105,14363
2021-04-21,7,9078,468,4812,1331,4,153,15846
2021-04-21,8,9077,580,5280,1553,16,196,16702
2021-04-21,9,9074,539,5341,1700,29,221,16904
2021-04-21,10,8831,553,5494,1705,57,225,16865
2021-04-21,11,8646,695,5226,1856,92,233,16748
2021-04-21,12,8641,819,4645,1969,120,202,16396
2021-04-21,13,8639,765,4254,2049,128,104,15939
2021-04-21,14,8636,669,4495,1934,120,88,15942
2021-04-21,15,8640,762,4521,2026,116,109,16174
2021-04-21,16,8635,966,4842,2004,112,143,16702
2021-04-21,17,8634,1518,5198,1664,86,214,17314
2021-04-21,18,8634,1616,5322,1348,52,199,17171
2021-04-21,19,8631,1347,5389,1231,14,167,16779
2021-04-21,20,8624,1377,5390,879,0,166,16436
2021-04-21,21,8628,1741,5221,664,0,185,16439
2021-04-21,22,8628,1299,4773,702,0,141,15543
2021-04-21,23,8635,618,4263,965,0,80,14561
2021-04-21,24,8628,434,4172,1244,0,32,14510
2021-04-22,1,8632,425,3561,1495,0,16,14129
2021-04-22,2,8629,258,3653,1720,0,19,14279
2021-04-22,3,8627,305,3669,1784,0,17,14402
2021-04-22,4,8632,390,3230,1845,0,17,14114
2021-04-22,5,8634,535,3298,2075,1,36,14579
2021-04-22,6,8635,624,4200,2072,4,74,15609
2021-04-22,7,8635,859,4937,1713,35,87,16266
2021-04-22,8,8631,1054,5246,1471,119,120,16641
2021-04-22,9,8634,865,4577,1356,246,97,15775
2021-04-22,10,8633,823,4402,1806,299,83,16046
2021-04-22,11,8632,513,4301,2041,277,83,15847
2021-04-22,12,8630,429,4042,2515,274,83,15973
2021-04-22,13,8631,270,3646,2773,241,83,15644
2021-04-22,14,8632,227,3685,2579,252,83,15458
2021-04-22,15,8630,236,3796,2734,212,83,15691
2021-04-22,16,8727,285,3892,2594,179,83,15760
2021-04-22,17,8899,367,4662,2477,151,91,16647
2021-04-22,18,8929,428,4622,2072,98,87,16236
2021-04-22,19,8927,454,4971,1465,18,86,15921
2021-04-22,20,8926,601,5492,953,0,124,16096
2021-04-22,21,8927,914,5159,1003,0,166,16169
2021-04-22,22,8928,787,4362,1283,0,87,15447
2021-04-22,23,8924,540,3984,1302,0,35,14785
2021-04-22,24,8961,333,3711,1716,0,17,14738
2021-04-23,1,9051,297,3538,1830,0,16,14732
2021-04-23,2,9052,288,3241,1954,0,15,14550
2021-04-23,3,9047,288,3128,2148,0,16,14627
2021-04-23,4,9043,288,3142,2181,0,16,14670
2021-04-23,5,9044,288,3647,1947,1,20,14947
2021-04-23,6,9047,296,4244,1845,3,26,15461
2021-04-23,7,9054,298,4128,1928,53,31,15492
2021-04-23,8,9055,299,4248,1568,181,31,15382
2021-04-23,9,9049,305,4391,1459,321,26,15551
2021-04-23,10,9055,309,4005,1429,404,27,15229
2021-04-23,11,9053,311,3880,1455,418,31,15148
2021-04-23,12,9052,313,3896,1892,416,31,15600
2021-04-23,13,9052,311,3464,1538,415,31,14811
2021-04-23,14,9065,311,3428,1648,416,31,14899
2021-04-23,15,9066,312,3474,1717,374,28,14971
2021-04-23,16,9031,309,3466,2217,326,26,15375
2021-04-23,17,9083,309,3687,2445,211,27,15762
2021-04-23,18,9086,308,4228,2146,91,25,15884
2021-04-23,19,9089,249,4230,2285,19,29,15901
2021-04-23,20,9085,218,4325,2690,0,32,16350
2021-04-23,21,9085,217,4106,2474,0,31,15913
2021-04-23,22,9088,220,3688,2127,0,31,15154
2021-04-23,23,9228,144,3301,2114,0,21,14808
2021-04-23,24,9314,140,2808,2272,0,5,14539
2021-04-24,1,9308,141,2575,1898,0,0,13922
2021-04-24,2,9278,141,2569,1844,0,0,13832
2021-04-24,3,9357,145,2560,1326,0,0,13388
2021-04-24,4,9554,142,2581,1285,0,0,13562
2021-04-24,5,9564,140,3012,957,2,0,13675
2021-04-24,6,9562,138,3373,733,5,0,13811
2021-04-24,7,9564,141,3591,540,49,0,13885
2021-04-24,8,9566,140,4005,296,141,0,14148
2021-04-24,9,9566,140,3982,222,254,0,14164
2021-04-24,10,9568,139,3754,300,358,0,14119
2021-04-24,11,9564,140,3564,376,385,0,14029
2021-04-24,12,9567,140,3491,490,388,0,14076
2021-04-24,13,9561,139,3280,634,361,0,13975
2021-04-24,14,9558,139,2982,886,342,0,13907
2021-04-24,15,9561,139,3199,721,303,0,13923
2021-04-24,16,9565,137,3874,723,192,0,14491
2021-04-24,17,9762,137,3974,856,119,0,14848
2021-04-24,18,9768,138,4451,688,52,0,15097
2021-04-24,19,9770,138,4416,699,14,0,15037
2021-04-24,20,9769,138,4379,798,0,0,15084
2021-04-24,21,9770,138,4309,963,0,0,15180
2021-04-24,22,9777,138,4144,751,0,0,14810
2021-04-24,23,9789,140,3665,768,0,0,14362
2021-04-24,24,9791,139,3151,715,0,0,13796
2021-04-25,1,9784,137,2725,694,0,0,13340
2021-04-25,2,9784,137,2617,748,0,0,13286
2021-04-25,3,9826,139,2537,730,0,0,13232
2021-04-25,4,9923,145,2605,635,0,0,13308
2021-04-25,5,9950,142,2532,579,0,0,13203
2021-04-25,6,9950,141,2610,731,2,0,13434
2021-04-25,7,9949,139,2843,1258,18,0,14207
2021-04-25,8,9946,140,3002,1613,37,0,14738
2021-04-25,9,9946,138,3086,1968,99,0,15237
2021-04-25,10,9943,140,3133,2112,129,0,15457
2021-04-25,11,9942,140,3078,2490,184,0,15834
2021-04-25,12,9942,141,2921,2428,263,0,15695
2021-04-25,13,9940,140,2939,2145,286,0,15450
2021-04-25,14,9943,139,2926,2190,324,0,15522
2021-04-25,15,9901,141,2847,2207,330,0,15426
2021-04-25,16,9938,139,2895,2463,295,0,15730
2021-04-25,17,9952,142,3288,2608,192,0,16182
2021-04-25,18,9961,141,3409,2466,81,0,16058
2021-04-25,19,9961,140,4028,2287,15,0,16431
2021-04-25,20,9956,141,4306,2185,1,0,16589
2021-04-25,21,9957,141,4046,1889,0,0,16033
2021-04-25,22,9965,140,3923,1569,0,0,15597
2021-04-25,23,9956,140,3654,1160,0,0,14910
2021-04-25,24,9961,139,3386,786,0,0,14272
2021-04-26,1,9968,141,3299,772,0,1,14181
2021-04-26,2,9985,141,3265,676,0,10,14077
2021-04-26,3,10006,161,3241,662,0,17,14087
2021-04-26,4,10009,168,3302,596,0,18,14093
2021-04-26,5,10003,185,3272,491,1,20,13972
2021-04-26,6,10013,226,3733,533,4,30,14539
2021-04-26,7,10013,224,4214,518,51,41,15061
2021-04-26,8,10013,225,4429,632,157,68,15524
2021-04-26,9,10013,224,4451,591,284,86,15649
2021-04-26,10,10013,224,3920,593,362,95,15207
2021-04-26,11,10012,238,3991,457,387,92,15177
2021-04-26,12,10008,307,4247,352,369,84,15367
2021-04-26,13,10013,238,3707,522,376,43,14899
2021-04-26,14,10024,224,3107,557,398,32,14342
2021-04-26,15,10030,223,3262,703,299,31,14548
2021-04-26,16,10030,223,3415,816,222,32,14738
2021-04-26,17,10028,224,4171,1138,138,32,15731
2021-04-26,18,10030,223,4266,1280,73,32,15904
2021-04-26,19,10025,221,4414,1539,17,32,16248
2021-04-26,20,10022,223,4224,1933,0,31,16433
2021-04-26,21,10024,223,3727,1906,0,31,15911
2021-04-26,22,10016,224,3360,1969,0,32,15601
2021-04-26,23,10024,224,3237,2010,0,23,15518
2021-04-26,24,10025,223,3008,2094,0,16,15366
2021-04-27,1,10037,222,2720,2126,0,15,15120
2021-04-27,2,10036,223,2600,1976,0,15,14850
2021-04-27,3,10037,223,2609,1745,0,15,14629
2021-04-27,4,10039,221,2757,1678,0,16,14711
2021-04-27,5,10046,222,2781,2159,1,21,15230
2021-04-27,6,10040,221,3238,2018,3,27,15547
2021-04-27,7,10040,222,4124,1833,30,33,16282
2021-04-27,8,10038,234,4506,1610,86,58,16532
2021-04-27,9,10040,248,4332,1346,138,87,16191
2021-04-27,10,10040,247,4310,1002,210,90,15899
2021-04-27,11,10032,253,3651,645,294,87,14962
2021-04-27,12,10046,247,3461,396,335,85,14570
2021-04-27,13,10045,274,3432,660,294,45,14750
2021-04-27,14,10047,371,3427,678,257,32,14812
2021-04-27,15,10051,399,3558,815,254,31,15108
2021-04-27,16,10053,400,3750,811,195,33,15242
2021-04-27,17,10054,400,4301,885,139,32,15811
2021-04-27,18,10053,399,4542,792,71,38,15895
2021-04-27,19,10057,399,5194,650,16,76,16392
2021-04-27,20,10049,403,4831,980,1,86,16350
2021-04-27,21,10050,242,4238,1336,0,84,15950
2021-04-27,22,10056,223,3620,1443,0,87,15429
2021-04-27,23,10052,224,3413,1253,0,66,15008
2021-04-27,24,10059,221,3109,1564,0,16,14969
2021-04-28,1,10071,222,2975,1067,0,16,14351
2021-04-28,2,10065,224,2750,897,0,16,13952
2021-04-28,3,10066,223,2794,654,0,16,13753
2021-04-28,4,10064,221,2917,826,0,17,14045
2021-04-28,5,10064,218,3043,963,2,19,14309
2021-04-28,6,10070,219,3180,1302,9,24,14804
2021-04-28,7,10064,226,3812,977,43,31,15153
2021-04-28,8,10057,230,4216,960,95,31,15589
2021-04-28,9,10062,239,4293,1391,153,32,16170
2021-04-28,10,10060,229,4345,1364,128,31,16157
2021-04-28,11,10068,227,4669,1313,156,32,16465
2021-04-28,12,10066,225,4293,1505,107,32,16228
2021-04-28,13,10068,219,3510,1513,113,33,15456
2021-04-28,14,10065,219,3422,828,128,32,14694
2021-04-28,15,10061,220,3494,1161,189,32,15157
2021-04-28,16,10058,217,3700,1646,172,32,15825
2021-04-28,17,10062,219,4502,1536,112,32,16463
2021-04-28,18,10066,218,4747,1152,44,31,16258
2021-04-28,19,10068,218,4913,1086,9,31,16325
2021-04-28,20,10069,220,5027,989,0,31,16336
2021-04-28,21,10055,221,4558,783,0,32,15649
2021-04-28,22,10058,223,3989,680,0,31,14981
2021-04-28,23,10067,224,3643,594,0,24,14552
2021-04-28,24,10063,223,3230,545,0,17,14078
2021-04-29,1,10064,222,2988,411,0,17,13702
2021-04-29,2,10071,222,3030,384,0,16,13723
2021-04-29,3,10068,223,2870,335,0,17,13513
2021-04-29,4,10064,221,3302,269,0,18,13874
2021-04-29,5,10065,223,3534,255,0,20,14097
2021-04-29,6,10065,225,3797,357,4,29,14477
2021-04-29,7,10071,230,4435,314,18,32,15100
2021-04-29,8,10069,252,5377,203,54,32,15987
2021-04-29,9,10066,319,5139,217,84,32,15857
2021-04-29,10,10065,237,5136,203,102,32,15775
2021-04-29,11,10063,219,4897,533,97,32,15841
2021-04-29,12,10063,219,4554,865,107,32,15840
2021-04-29,13,10069,184,4221,751,111,32,15368
2021-04-29,14,10069,211,4367,971,92,32,15742
2021-04-29,15,10075,203,4659,1078,88,32,16135
2021-04-29,16,10080,201,4990,878,60,32,16241
2021-04-29,17,10076,203,4620,918,46,31,15894
2021-04-29,18,10078,213,4639,682,28,31,15671
2021-04-29,19,10075,214,4760,887,5,32,15973
2021-04-29,20,10072,215,4407,951,0,32,15677
2021-04-29,21,10066,216,3997,617,0,32,14928
2021-04-29,22,10068,216,3724,691,0,32,14731
2021-04-29,23,10061,215,3049,1028,0,25,14378
2021-04-29,24,10057,214,2796,1176,0,18,14261
2021-04-30,1,10060,213,2638,906,0,18,13835
2021-04-30,2,10018,216,2577,530,0,17,13358
2021-04-30,3,9597,216,2682,716,0,17,13228
2021-04-30,4,9515,219,2625,976,0,18,13353
2021-04-30,5,9533,219,2720,1226,1,21,13720
2021-04-30,6,9900,219,2829,2107,2,31,15088
2021-04-30,7,10056,219,3056,2671,13,32,16047
2021-04-30,8,10053,221,3211,3069,51,32,16637
2021-04-30,9,10055,221,3206,3288,111,32,16913
2021-04-30,10,10052,220,3216,3081,191,32,16792
2021-04-30,11,10046,221,3104,3222,222,32,16847
2021-04-30,12,10043,222,2883,3324,239,32,16743
2021-04-30,13,10044,223,2906,2817,251,32,16273
2021-04-30,14,10048,224,3020,2599,280,32,16203
2021-04-30,15,10051,221,3114,2921,254,32,16593
2021-04-30,16,10047,221,3153,3319,172,32,16944
2021-04-30,17,10046,222,3219,3348,163,32,17030
2021-04-30,18,10050,222,3374,3057,92,32,16827
2021-04-30,19,10047,225,3955,2856,23,31,17137
2021-04-30,20,10048,226,4096,2495,0,32,16897
2021-04-30,21,10050,226,4082,2128,0,32,16518
2021-04-30,22,10053,226,3855,2078,0,32,16244
2021-04-30,23,10058,143,3605,1856,0,25,15687
2021-04-30,24,10055,131,3074,1392,0,2,14654
2021-05-01,1,10054,131,2818,1387,0,0,14390
2021-05-01,2,10052,131,3120,969,0,0,14272
2021-05-01,3,10053,131,3259,787,0,0,14230
2021-05-01,4,10049,130,3250,881,0,0,14310
2021-05-01,5,10049,128,3349,684,2,0,14212
2021-05-01,6,10054,128,3532,550,6,0,14270
2021-05-01,7,10056,127,3741,445,45,0,14414
2021-05-01,8,10048,128,3912,400,156,0,14644
2021-05-01,9,10054,128,3863,514,300,0,14859
2021-05-01,10,10054,128,3761,911,363,0,15217
2021-05-01,11,10053,129,3581,1033,387,0,15183
2021-05-01,12,10049,128,3239,1526,390,0,15332
2021-05-01,13,10044,128,2941,1406,374,0,14893
2021-05-01,14,10051,129,2783,1185,321,0,14469
2021-05-01,15,10046,129,2914,875,237,0,14201
2021-05-01,16,10044,129,3102,1474,247,0,14996
2021-05-01,17,10042,129,3402,2551,106,0,16230
2021-05-01,18,10044,128,3503,2696,43,0,16414
2021-05-01,19,10037,129,3637,2856,11,0,16670
2021-05-01,20,10036,129,3665,2836,0,0,16666
2021-05-01,21,10043,129,3585,2378,0,0,16135
2021-05-01,22,10040,129,3453,2086,0,0,15708
2021-05-01,23,10040,128,3355,1375,0,0,14898
2021-05-01,24,9850,128,3215,796,0,0,13989
2021-05-02,1,9573,129,3070,822,0,0,13594
2021-05-02,2,9281,129,3019,1167,0,0,13596
2021-05-02,3,9197,129,2986,889,0,0,13201
2021-05-02,4,9196,129,3120,707,0,0,13152
2021-05-02,5,9199,129,3163,637,2,0,13130
2021-05-02,6,9203,129,3230,809,2,0,13373
2021-05-02,7,9202,129,3329,950,25,0,13635
2021-05-02,8,9255,129,3145,1618,63,0,14210
2021-05-02,9,9818,128,3113,1374,122,10,14565
2021-05-02,10,10045,129,3272,1174,188,39,14847
2021-05-02,11,10047,130,3254,1193,247,54,14925
2021-05-02,12,10050,133,3183,1284,294,54,14998
2021-05-02,13,10050,134,3111,961,362,54,14672
2021-05-02,14,10000,135,3180,734,355,43,14447
2021-05-02,15,10057,132,3315,987,297,0,14788
2021-05-02,16,10053,133,3542,1082,285,0,15095
2021-05-02,17,10052,134,3730,1395,179,0,15490
2021-05-02,18,10055,133,3792,1470,81,0,15531
2021-05-02,19,10050,133,3935,1487,19,0,15624
2021-05-02,20,10049,135,4118,1781,0,0,16083
2021-05-02,21,10048,134,4017,1749,0,0,15948
2021-05-02,22,10050,135,3765,1727,0,0,15677
2021-05-02,23,10044,137,3439,1110,0,0,14730
2021-05-02,24,10048,137,2976,1020,0,0,14181
2021-05-03,1,9860,138,2866,834,0,0,13698
2021-05-03,2,9801,137,2765,925,0,10,13638
2021-05-03,3,9800,138,2724,779,0,17,13458
2021-05-03,4,9797,138,2747,1154,0,20,13856
2021-05-03,5,9860,136,2758,1396,1,20,14171
2021-05-03,6,10048,135,3038,939,4,26,14190
2021-05-03,7,10043,136,3620,1202,23,30,15054
2021-05-03,8,9217,207,4878,1457,56,30,15845
2021-05-03,9,9179,207,4678,1561,90,30,15745
2021-05-03,10,9180,139,4791,1442,109,30,15691
2021-05-03,11,9175,166,4750,1378,170,31,15670
2021-05-03,12,9171,294,4801,1197,188,31,15682
2021-05-03,13,9172,376,4648,1083,139,30,15448
2021-05-03,14,9179,353,4400,1024,170,31,15157
2021-05-03,15,9193,370,4356,1029,149,31,15128
2021-05-03,16,9189,403,4564,1063,102,31,15352
2021-05-03,17,9188,681,4905,1034,61,31,15900
2021-05-03,18,9186,964,4868,1050,29,32,16129
2021-05-03,19,9186,839,4936,1146,6,32,16145
2021-05-03,20,9184,541,4949,1363,0,33,16070
2021-05-03,21,9184,447,4408,1075,0,32,15146
2021-05-03,22,9185,438,3781,1013,0,32,14449
2021-05-03,23,9187,256,3507,1012,0,25,13987
2021-05-03,24,9186,208,3343,1112,0,17,13866
2021-05-04,1,9186,230,2885,974,0,17,13292
2021-05-04,2,9188,233,2833,855,0,17,13126
2021-05-04,3,9184,234,2842,932,0,17,13209
2021-05-04,4,9181,245,2938,1085,0,17,13466
2021-05-04,5,9180,277,2955,966,1,20,13399
2021-05-04,6,9185,395,2990,1106,4,25,13705
2021-05-04,7,9180,400,4077,1398,13,31,15099
2021-05-04,8,9177,481,4884,1298,57,31,15928
2021-05-04,9,9177,714,4891,1158,91,32,16063
2021-05-04,10,9176,928,4727,988,116,31,15966
2021-05-04,11,9180,1088,4543,1111,127,31,16080
2021-05-04,12,9180,1182,4366,1281,176,33,16218
2021-05-04,13,9174,1067,4429,1118,167,37,15992
2021-05-04,14,9170,1075,4523,927,167,51,15913
2021-05-04,15,9168,1057,4468,1064,103,83,15943
2021-05-04,16,9175,1035,4558,1091,77,82,16018
2021-05-04,17,9176,1363,4818,1497,43,81,16978
2021-05-04,18,9179,1190,4277,1799,23,85,16553
2021-05-04,19,9176,1073,4538,1550,5,75,16417
2021-05-04,20,9176,514,4510,1974,0,33,16207
2021-05-04,21,9179,262,4828,1583,0,34,15886
2021-05-04,22,9161,205,4347,1373,0,32,15118
2021-05-04,23,9178,205,3636,1277,1,26,14323
2021-05-04,24,9172,206,3337,1275,1,20,14011
2021-05-05,1,9166,206,2936,1272,0,16,13596
2021-05-05,2,9175,204,2802,1122,0,16,13319
2021-05-05,3,9174,206,3007,1267,0,16,13670
2021-05-05,4,9187,206,2719,1272,0,16,13400
2021-05-05,5,9215,206,2916,1232,1,19,13589
2021-05-05,6,9655,206,3052,1343,3,27,14286
2021-05-05,7,9670,206,3726,1462,21,31,15116
2021-05-05,8,9673,218,4082,1504,59,31,15567
2021-05-05,9,9678,329,4125,1768,79,31,16010
2021-05-05,10,9645,431,3920,1887,94,31,16008
2021-05-05,11,9593,623,3387,1491,111,32,15237
2021-05-05,12,8805,624,4176,1770,115,31,15521
2021-05-05,13,8804,626,4108,1895,159,31,15623
2021-05-05,14,8798,628,3522,1846,176,32,15002
2021-05-05,15,8802,628,3825,1679,111,33,15078
2021-05-05,16,8802,629,4078,1759,96,32,15396
2021-05-05,17,8803,304,4375,1891,75,32,15480
2021-05-05,18,8798,206,4798,1563,48,33,15446
2021-05-05,19,8798,207,5234,1366,16,51,15672
2021-05-05,20,8800,211,5371,1095,0,82,15559
2021-05-05,21,8805,265,5206,1081,0,90,15447
2021-05-05,22,8808,231,4485,1119,0,86,14729
2021-05-05,23,8797,214,3979,1110,0,81,14181
2021-05-05,24,8973,215,3723,1055,0,76,14042
2021-05-06,1,9041,215,3516,925,0,91,13788
2021-05-06,2,9111,214,3334,769,0,74,13502
2021-05-06,3,9140,319,3160,730,0,71,13420
2021-05-06,4,9173,460,3213,588,0,67,13501
2021-05-06,5,9171,637,3249,464,1,68,13590
2021-05-06,6,9174,638,3850,483,11,38,14194
2021-05-06,7,9175,641,4392,330,61,33,14632
2021-05-06,8,9181,641,4229,212,191,33,14487
2021-05-06,9,9186,644,4258,189,329,32,14638
2021-05-06,10,9180,653,4045,174,380,32,14464
2021-05-06,11,9185,340,4116,289,391,31,14352
2021-05-06,12,9183,251,3799,482,378,32,14125
2021-05-06,13,9177,383,3584,632,340,32,14148
2021-05-06,14,9176,613,3507,767,316,32,14411
2021-05-06,15,9174,868,3359,766,297,32,14496
2021-05-06,16,9180,899,3754,631,262,32,14758
2021-05-06,17,9177,900,4119,580,164,32,14972
2021-05-06,18,9178,949,4398,531,79,32,15167
2021-05-06,19,9180,938,4619,353,21,53,15164
2021-05-06,20,9183,945,4869,297,1,87,15382
2021-05-06,21,9188,939,4542,298,0,88,15055
2021-05-06,22,9175,314,4650,407,0,87,14633
2021-05-06,23,9190,161,3855,442,0,83,13731
2021-05-06,24,9183,137,3533,573,0,78,13504
2021-05-07,1,9178,144,3743,504,0,73,13642
2021-05-07,2,9186,154,3389,389,0,31,13149
2021-05-07,3,9187,261,3504,228,0,17,13197
2021-05-07,4,9197,451,3556,167,0,17,13388
2021-05-07,5,9197,771,3470,114,0,20,13572
2021-05-07,6,9195,952,3460,101,7,32,13747
2021-05-07,7,9192,1035,4414,130,44,53,14868
2021-05-07,8,9188,1014,4635,145,91,83,15156
2021-05-07,9,9190,1142,4526,154,118,87,15217
2021-05-07,10,9204,941,4217,137,183,87,14769
2021-05-07,11,9198,933,3998,158,190,87,14564
2021-05-07,12,9189,949,3909,182,192,86,14507
2021-05-07,13,9185,923,3857,226,224,43,14458
2021-05-07,14,9184,898,3601,289,182,32,14186
2021-05-07,15,9177,899,3640,196,25,32,13969
2021-05-07,16,9178,898,4071,137,30,32,14346
2021-05-07,17,9186,896,4122,126,8,34,14372
2021-05-07,18,9188,738,4315,147,26,46,14460
2021-05-07,19,9188,707,4396,219,19,79,14608
2021-05-07,20,9188,714,4409,296,1,88,14696
2021-05-07,21,9187,722,4342,253,0,86,14590
2021-05-07,22,9189,566,4075,311,0,86,14227
2021-05-07,23,9192,214,3677,380,0,61,13524
2021-05-07,24,9191,121,3407,509,0,8,13236
2021-05-08,1,9185,121,3241,788,0,0,13335
2021-05-08,2,9183,121,2906,995,0,0,13205
2021-05-08,3,9181,120,2875,912,0,0,13088
2021-05-08,4,9189,114,2761,1168,0,0,13232
2021-05-08,5,9194,110,2810,1083,1,0,13198
2021-05-08,6,9199,110,2866,1230,4,0,13409
2021-05-08,7,9201,111,3060,1446,36,0,13854
2021-05-08,8,9197,111,3550,1203,105,0,14166
2021-05-08,9,9199,111,3771,1132,175,0,14388
2021-05-08,10,9196,111,3799,1162,261,0,14529
2021-05-08,11,9197,112,3919,1007,291,0,14526
2021-05-08,12,9199,166,4250,909,254,0,14778
2021-05-08,13,9202,129,3664,1091,221,0,14307
2021-05-08,14,9206,128,3190,985,190,0,13699
2021-05-08,15,9200,149,3651,994,172,0,14166
2021-05-08,16,9209,192,3995,921,197,0,14514
2021-05-08,17,9206,304,4337,665,148,0,14660
2021-05-08,18,9211,294,4739,531,54,0,14829
2021-05-08,19,9214,294,4960,309,22,0,14799
2021-05-08,20,9209,300,5016,282,0,0,14807
2021-05-08,21,9205,324,5255,322,0,0,15106
2021-05-08,22,9204,308,4648,340,0,0,14500
2021-05-08,23,9200,152,4398,332,0,0,14082
2021-05-08,24,9198,111,3642,293,0,0,13244
2021-05-09,1,9190,109,3242,334,0,0,12875
2021-05-09,2,9213,110,3063,269,0,0,12655
2021-05-09,3,9209,110,3010,319,0,0,12648
2021-05-09,4,9212,114,3105,283,0,0,12714
2021-05-09,5,9217,111,3045,271,2,0,12646
2021-05-09,6,9203,111,3087,240,10,0,12651
2021-05-09,7,8973,111,3437,259,64,0,12844
2021-05-09,8,8969,111,3681,201,140,0,13102
2021-05-09,9,8966,110,3894,187,234,0,13391
2021-05-09,10,8969,111,3840,294,274,0,13488
2021-05-09,11,8965,112,3816,333,296,0,13522
2021-05-09,12,8967,120,4107,346,280,0,13820
2021-05-09,13,8968,179,3939,487,255,0,13828
2021-05-09,14,8983,125,3321,671,222,2,13324
2021-05-09,15,9200,121,3263,830,178,1,13593
2021-05-09,16,9214,120,3618,413,119,0,13484
2021-05-09,17,9214,115,3834,718,88,0,13969
2021-05-09,18,9218,113,4290,903,65,0,14589
2021-05-09,19,9216,115,4732,751,24,0,14838
2021-05-09,20,9220,164,5133,709,1,0,15227
2021-05-09,21,9214,275,5161,607,0,0,15257
2021-05-09,22,9219,171,4430,733,0,0,14553
2021-05-09,23,9212,113,3672,895,0,0,13892
2021-05-09,24,9211,113,2996,960,0,0,13280
2021-05-10,1,9205,114,2870,973,0,0,13162
2021-05-10,2,9206,114,2874,913,0,7,13114
2021-05-10,3,9204,114,3000,929,0,12,13259
2021-05-10,4,9207,114,3314,786,0,12,13433
2021-05-10,5,9200,112,3381,803,1,15,13512
2021-05-10,6,9200,116,3815,868,9,20,14028
2021-05-10,7,9197,212,4694,704,51,33,14891
2021-05-10,8,9197,423,5031,639,161,31,15482
2021-05-10,9,9197,327,4355,727,277,28,14911
2021-05-10,10,9196,244,4235,886,337,25,14923
2021-05-10,11,9195,126,4307,932,322,25,14907
2021-05-10,12,9194,122,4433,1067,292,25,15133
2021-05-10,13,9196,122,3775,1416,296,25,14830
2021-05-10,14,9203,122,3525,1254,294,25,14423
2021-05-10,15,9202,121,3529,1196,296,25,14369
2021-05-10,16,9195,120,3729,1314,258,26,14642
2021-05-10,17,9196,120,3959,1906,168,25,15374
2021-05-10,18,9192,117,4276,1834,87,25,15531
2021-05-10,19,9191,111,4910,1377,21,25,15635
2021-05-10,20,9193,112,5079,1144,0,25,15553
2021-05-10,21,9197,111,4956,981,0,27,15272
2021-05-10,22,8610,111,4730,874,0,27,14352
2021-05-10,23,8377,111,4318,795,0,5,13606
2021-05-10,24,8374,111,3968,832,0,9,13294
2021-05-11,1,8372,111,3380,726,0,13,12602
2021-05-11,2,8372,110,3239,743,0,13,12477
2021-05-11,3,8364,110,3254,1136,0,13,12877
2021-05-11,4,8366,110,3334,1248,0,13,13071
2021-05-11,5,8372,110,3265,1157,1,15,12920
2021-05-11,6,8372,111,3434,1481,11,23,13432
2021-05-11,7,8366,109,3892,1706,59,27,14159
2021-05-11,8,8362,111,4348,1807,145,27,14800
2021-05-11,9,8357,111,4433,1874,255,27,15057
2021-05-11,10,8360,113,4605,2042,295,28,15443
2021-05-11,11,8362,113,3788,2155,291,27,14736
2021-05-11,12,8362,113,3589,2193,302,27,14586
2021-05-11,13,8366,112,3561,2015,272,27,14353
2021-05-11,14,8368,112,3764,2177,291,27,14739
2021-05-11,15,8367,114,3885,2263,260,27,14916
2021-05-11,16,8364,118,3958,2227,246,27,14940
2021-05-11,17,8361,145,4689,2220,150,27,15592
2021-05-11,18,8366,203,5029,1826,66,27,15517
2021-05-11,19,8362,227,5515,1706,25,27,15862
2021-05-11,20,8391,393,5487,1505,0,30,15806
2021-05-11,21,8587,340,5086,1411,0,32,15456
2021-05-11,22,8583,298,4667,1149,0,32,14729
2021-05-11,23,8749,299,4136,1178,0,21,14383
2021-05-11,24,8908,133,3571,1202,0,17,13831
2021-05-12,1,9038,112,3405,1405,0,17,13977
2021-05-12,2,9034,111,2756,1662,0,17,13580
2021-05-12,3,9035,111,2745,1646,0,14,13551
2021-05-12,4,9042,111,2683,1619,0,15,13470
2021-05-12,5,9062,114,2887,1488,1,32,13584
2021-05-12,6,9056,116,3480,1273,9,49,13983
2021-05-12,7,9053,116,4211,1143,66,48,14637
2021-05-12,8,9057,117,4700,640,200,44,14758
2021-05-12,9,9064,116,4319,388,333,42,14262
2021-05-12,10,9067,115,3732,457,406,43,13820
2021-05-12,11,9067,115,3633,703,422,40,13980
2021-05-12,12,9081,117,3536,927,413,43,14117
2021-05-12,13,9149,115,3283,806,408,52,13813
2021-05-12,14,9106,116,3315,796,322,50,13705
2021-05-12,15,9105,117,3665,615,375,50,13927
2021-05-12,16,9099,113,3820,749,348,54,14183
2021-05-12,17,9101,114,4372,1081,238,55,14961
2021-05-12,18,9101,116,4629,1261,114,55,15276
2021-05-12,19,9100,138,4651,1020,26,57,14992
2021-05-12,20,9100,139,4664,759,4,58,14724
2021-05-12,21,9098,141,4616,800,0,53,14708
2021-05-12,22,9097,141,4434,949,0,33,14654
2021-05-12,23,9097,141,4003,872,0,23,14136
2021-05-12,24,9112,143,3536,884,0,19,13694
2021-05-13,1,9180,122,3153,855,0,15,13325
2021-05-13,2,9194,111,2830,840,0,15,12990
2021-05-13,3,9193,112,2915,731,0,15,12966
2021-05-13,4,9189,112,2889,738,0,16,12944
2021-05-13,5,9197,111,3030,908,2,19,13267
2021-05-13,6,9198,121,3428,888,9,26,13670
2021-05-13,7,9197,142,4247,630,59,31,14306
2021-05-13,8,9196,171,4960,234,172,31,14764
2021-05-13,9,9198,253,4847,220,314,31,14863
2021-05-13,10,9204,155,4361,323,397,31,14471
2021-05-13,11,9206,145,3921,410,424,31,14137
2021-05-13,12,9204,143,3887,594,406,33,14267
2021-05-13,13,9194,139,3747,788,376,33,14277
2021-05-13,14,9200,138,3515,880,344,33,14110
2021-05-13,15,9196,137,3734,907,354,32,14360
2021-05-13,16,9201,124,4019,865,303,32,14544
2021-05-13,17,9197,136,4800,851,231,32,15247
2021-05-13,18,9198,115,4585,758,110,32,14798
2021-05-13,19,9192,118,4811,620,25,32,14798
2021-05-13,20,9189,142,4903,582,0,32,14848
2021-05-13,21,9196,143,5007,596,0,32,14974
2021-05-13,22,9196,143,4530,612,0,32,14513
2021-05-13,23,9200,127,3695,566,0,22,13610
2021-05-13,24,9200,139,3304,566,0,16,13225
2021-05-14,1,9198,123,3229,729,0,15,13294
2021-05-14,2,9206,115,3119,404,0,15,12859
2021-05-14,3,9206,116,3121,404,0,15,12862
2021-05-14,4,9203,116,3127,496,0,16,12958
2021-05-14,5,9210,115,3211,438,2,22,12998
2021-05-14,6,9208,113,3392,530,10,29,13282
2021-05-14,7,9206,130,4374,512,66,32,14320
2021-05-14,8,9204,123,4816,245,195,32,14615
2021-05-14,9,9201,151,5129,107,316,20,14924
2021-05-14,10,9209,119,4791,131,401,32,14683
2021-05-14,11,9213,116,4423,235,426,32,14445
2021-05-14,12,9203,114,4428,384,430,32,14591
2021-05-14,13,9196,124,4053,676,408,32,14489
2021-05-14,14,9208,121,3524,789,401,32,14075
2021-05-14,15,9212,113,3617,1035,378,32,14387
2021-05-14,16,9217,113,3806,715,318,32,14201
2021-05-14,17,9214,129,4434,697,235,32,14741
2021-05-14,18,9210,132,4734,570,107,32,14785
2021-05-14,19,9207,132,4664,1076,24,32,15135
2021-05-14,20,9201,133,4859,1052,1,32,15278
2021-05-14,21,9197,133,4785,728,0,32,14875
2021-05-14,22,9196,133,4338,982,0,32,14681
2021-05-14,23,9199,119,3727,909,0,22,13976
2021-05-14,24,9201,113,3502,792,0,14,13622
2021-05-15,1,9201,112,3284,708,0,5,13310
2021-05-15,2,9199,110,2950,635,0,0,12894
2021-05-15,3,9196,109,2968,434,0,0,12707
2021-05-15,4,9201,109,3054,563,0,0,12927
2021-05-15,5,9206,110,3130,494,2,0,12942
2021-05-15,6,9209,110,3333,346,15,0,13013
2021-05-15,7,9209,111,3529,246,69,0,13164
2021-05-15,8,9213,110,3821,123,180,0,13447
2021-05-15,9,9212,111,3969,108,288,0,13688
2021-05-15,10,9208,110,3662,129,357,0,13466
2021-05-15,11,9212,110,3567,146,385,0,13420
2021-05-15,12,9203,112,3684,269,381,0,13649
2021-05-15,13,9202,112,3409,401,338,0,13462
2021-05-15,14,9199,111,3467,733,374,0,13884
2021-05-15,15,9193,112,3449,692,379,0,13825
2021-05-15,16,9196,116,3595,610,327,0,13844
2021-05-15,17,9193,119,4204,640,191,0,14347
2021-05-15,18,9196,118,4374,578,100,0,14366
2021-05-15,19,9191,117,4849,481,31,0,14669
2021-05-15,20,9125,119,4826,423,4,0,14497
2021-05-15,21,8300,215,5351,433,0,0,14299
2021-05-15,22,8300,133,4676,450,0,0,13559
2021-05-15,23,8294,122,3922,442,0,0,12780
2021-05-15,24,8287,121,3654,454,0,0,12516
2021-05-16,1,8297,121,3567,516,0,0,12501
2021-05-16,2,8294,120,3499,616,0,0,12529
2021-05-16,3,8304,120,3305,603,0,0,12332
2021-05-16,4,8298,120,3414,451,0,0,12283
2021-05-16,5,8298,119,3773,292,1,0,12483
2021-05-16,6,8295,119,3732,253,11,0,12410
2021-05-16,7,8295,121,3503,277,61,1,12258
2021-05-16,8,8290,136,4051,152,164,1,12794
2021-05-16,9,8285,138,4305,110,240,0,13078
2021-05-16,10,8283,139,4581,72,301,0,13376
2021-05-16,11,8285,139,4191,101,364,0,13080
2021-05-16,12,8281,139,4286,177,383,0,13266
2021-05-16,13,8277,139,4287,295,368,0,13366
2021-05-16,14,8278,138,3980,374,379,0,13149
2021-05-16,15,8270,138,4149,430,321,0,13308
2021-05-16,16,8268,138,4223,349,294,0,13272
2021-05-16,17,8266,127,4863,304,212,0,13772
2021-05-16,18,8265,235,5328,225,110,0,14163
2021-05-16,19,8264,168,5451,214,27,0,14124
2021-05-16,20,8266,117,5416,225,2,0,14026
2021-05-16,21,8270,116,5369,261,0,0,14016
2021-05-16,22,8270,115,4833,336,0,0,13554
2021-05-16,23,8271,116,4655,379,0,0,13421
2021-05-16,24,8272,116,4237,388,0,1,13014
2021-05-17,1,8274,115,3695,517,0,11,12612
2021-05-17,2,8270,139,3946,586,0,16,12957
2021-05-17,3,8269,145,3398,578,0,17,12407
2021-05-17,4,8275,150,3237,514,0,17,12193
2021-05-17,5,8517,157,3148,433,1,20,12276
2021-05-17,6,8728,186,3376,641,14,29,12974
2021-05-17,7,8731,308,3845,687,71,32,13674
2021-05-17,8,8732,326,4607,352,178,32,14227
2021-05-17,9,8729,420,4543,226,274,51,14243
2021-05-17,10,8730,505,4355,170,353,84,14197
2021-05-17,11,8723,623,4343,169,382,90,14330
2021-05-17,12,8719,850,4062,246,377,90,14344
2021-05-17,13,8712,1006,4024,345,367,88,14542
2021-05-17,14,8710,1332,3805,467,363,88,14765
2021-05-17,15,8719,1512,3567,454,365,89,14706
2021-05-17,16,8725,1563,3829,416,322,93,14948
2021-05-17,17,8764,1634,4235,322,208,95,15258
2021-05-17,18,8923,1489,4519,294,102,60,15387
2021-05-17,19,8927,1429,4730,320,27,43,15476
2021-05-17,20,8919,1257,4889,350,5,41,15461
2021-05-17,21,8924,1086,4695,457,0,15,15177
2021-05-17,22,8910,866,4468,547,0,13,14804
2021-05-17,23,8915,604,4013,676,0,13,14221
2021-05-17,24,8987,569,3418,407,0,14,13395
2021-05-18,1,9021,576,3132,387,0,16,13132
2021-05-18,2,9078,580,2837,269,0,17,12781
2021-05-18,3,9078,576,2815,213,0,19,12701
2021-05-18,4,9071,585,2887,268,0,19,12830
2021-05-18,5,9071,610,2948,146,1,29,12805
2021-05-18,6,9068,648,3226,289,11,46,13288
2021-05-18,7,9068,679,3427,242,57,40,13513
2021-05-18,8,9065,717,3563,193,171,42,13751
2021-05-18,9,9062,844,3726,164,276,46,14118
2021-05-18,10,9064,1044,3921,204,353,50,14636
2021-05-18,11,9072,1331,3754,220,380,62,14819
2021-05-18,12,9072,1515,3750,296,397,88,15118
2021-05-18,13,9068,1541,3613,439,421,89,15171
2021-05-18,14,9064,1666,3601,258,377,88,15054
2021-05-18,15,9067,1672,3707,284,358,87,15175
2021-05-18,16,9089,1723,3948,313,321,85,15479
2021-05-18,17,9096,1573,4747,421,219,85,16141
2021-05-18,18,9088,1341,5187,392,109,87,16204
2021-05-18,19,9095,1124,5385,404,31,99,16138
2021-05-18,20,9094,1037,5196,526,5,114,15972
2021-05-18,21,9100,977,5280,675,0,86,16118
2021-05-18,22,9094,331,4561,844,0,85,14915
2021-05-18,23,9099,117,4037,994,0,78,14325
2021-05-18,24,9101,115,3386,1068,0,60,13730
2021-05-19,1,9109,113,3225,1000,0,17,13464
2021-05-19,2,9124,115,3161,1140,0,16,13556
2021-05-19,3,9128,173,2904,950,0,16,13171
2021-05-19,4,9124,265,2864,734,0,16,13003
2021-05-19,5,9126,316,2897,794,2,37,13172
2021-05-19,6,9124,326,3090,926,13,75,13554
2021-05-19,7,9124,336,3856,1037,74,87,14514
2021-05-19,8,9125,477,4560,677,179,87,15105
2021-05-19,9,9125,736,4834,429,288,87,15499
2021-05-19,10,9126,947,4735,561,374,88,15831
2021-05-19,11,9122,1303,4495,614,393,85,16012
2021-05-19,12,9134,1562,4210,665,404,87,16062
2021-05-19,13,9143,1712,4198,710,407,87,16257
2021-05-19,14,9142,1932,4304,668,361,87,16494
2021-05-19,15,9136,2054,4759,664,260,87,16960
2021-05-19,16,9140,2516,4798,676,197,87,17414
2021-05-19,17,9140,1918,5667,652,160,103,17640
2021-05-19,18,9142,1850,5417,661,92,95,17257
2021-05-19,19,9142,1614,5258,686,30,89,16819
2021-05-19,20,9144,1406,5255,865,2,88,16760
2021-05-19,21,9142,1389,4864,1321,0,88,16804
2021-05-19,22,9144,1004,4345,1462,0,87,16042
2021-05-19,23,9140,680,3752,1658,0,42,15272
2021-05-19,24,9156,635,3511,1562,0,22,14886
2021-05-20,1,9157,465,3516,1360,0,23,14521
2021-05-20,2,9162,423,3498,1079,0,20,14182
2021-05-20,3,9165,459,3324,755,0,18,13721
2021-05-20,4,9171,505,3384,573,0,18,13651
2021-05-20,5,9179,705,3273,406,1,21,13585
2021-05-20,6,9330,862,3350,203,8,30,13783
2021-05-20,7,9323,1120,3842,391,58,56,14790
2021-05-20,8,9319,1476,4233,437,101,84,15650
2021-05-20,9,9333,1790,4394,328,195,86,16126
2021-05-20,10,9333,2182,4168,251,306,86,16326
2021-05-20,11,9347,2497,3853,234,371,85,16387
2021-05-20,12,9380,2532,3974,254,385,86,16611
2021-05-20,13,9626,2657,4171,283,397,86,17220
2021-05-20,14,9632,2867,4521,254,356,85,17715
2021-05-20,15,9634,3082,4524,247,295,85,17867
2021-05-20,16,9630,3423,4723,278,236,85,18375
2021-05-20,17,9623,3834,5053,285,163,93,19051
2021-05-20,18,9622,3671,5200,333,93,87,19006
2021-05-20,19,9616,3562,5442,416,23,87,19146
2021-05-20,20,9617,2988,5390,648,2,83,18728
2021-05-20,21,9612,2778,5132,861,0,89,18472
2021-05-20,22,9625,1947,4587,1200,0,44,17403
2021-05-20,23,9635,1488,3774,1363,0,28,16288
2021-05-20,24,9629,992,3511,1256,0,18,15406
2021-05-21,1,9625,629,3179,1530,0,17,14980
2021-05-21,2,9629,638,2976,1070,0,17,14330
2021-05-21,3,9625,750,3105,868,0,17,14365
2021-05-21,4,9631,920,3016,481,0,17,14065
2021-05-21,5,9634,1072,3078,531,1,20,14336
2021-05-21,6,9642,1134,3041,600,12,26,14455
2021-05-21,7,9650,1564,3313,429,50,56,15062
2021-05-21,8,9636,1777,3648,450,132,85,15728
2021-05-21,9,9638,2083,3984,850,239,84,16878
2021-05-21,10,9627,2352,4165,821,324,83,17372
2021-05-21,11,9625,2600,4191,841,385,84,17726
2021-05-21,12,9631,2856,4416,951,404,85,18343
2021-05-21,13,9629,3061,4433,1027,388,87,18625
2021-05-21,14,9627,3150,4613,1092,355,87,18924
2021-05-21,15,9617,3267,4941,1115,315,85,19340
2021-05-21,16,9613,3375,5050,1137,235,86,19496
2021-05-21,17,9600,3272,5488,1070,160,87,19677
2021-05-21,18,9782,3107,5564,1017,96,86,19652
2021-05-21,19,9825,3330,5306,1000,34,87,19582
2021-05-21,20,9831,3075,5098,1095,6,87,19192
2021-05-21,21,9826,2678,4788,1232,0,88,18612
2021-05-21,22,9814,2279,4190,1268,0,47,17598
2021-05-21,23,9827,1187,3620,1397,0,17,16048
2021-05-21,24,9836,205,3337,1502,0,5,14885
2021-05-22,1,9849,77,2965,1310,0,0,14201
2021-05-22,2,9853,82,2937,1257,0,1,14130
2021-05-22,3,9850,114,2951,1302,0,1,14218
2021-05-22,4,9858,160,3038,1095,0,0,14151
2021-05-22,5,9861,375,3064,1000,2,0,14302
2021-05-22,6,9852,527,3004,734,4,0,14121
2021-05-22,7,9855,655,3101,459,37,7,14114
2021-05-22,8,9850,747,3382,410,96,7,14492
2021-05-22,9,9848,933,3824,649,153,1,15408
2021-05-22,10,9852,1271,4060,830,239,8,16260
2021-05-22,11,9855,1888,4113,928,164,41,16989
2021-05-22,12,9850,1887,3815,1111,247,55,16965
2021-05-22,13,9853,1956,3802,911,252,56,16830
2021-05-22,14,9859,2117,3786,530,228,54,16574
2021-05-22,15,9856,2230,3756,755,233,55,16885
2021-05-22,16,9859,2093,3854,842,141,57,16846
2021-05-22,17,9850,1843,4143,1161,124,59,17180
2021-05-22,18,9849,1611,4393,1019,72,57,17001
2021-05-22,19,9845,1394,4478,1029,27,57,16830
2021-05-22,20,9844,1195,4350,1011,5,55,16460
2021-05-22,21,9844,870,4384,1161,0,62,16321
2021-05-22,22,9850,376,4122,1358,0,54,15760
2021-05-22,23,9846,153,3585,1554,0,0,15138
2021-05-22,24,9853,123,3070,1818,0,0,14864
2021-05-23,1,9859,123,3000,1644,0,0,14626
2021-05-23,2,9857,123,2662,1753,0,0,14395
2021-05-23,3,9848,123,2687,1195,0,0,13853
2021-05-23,4,9855,123,2713,1155,0,0,13846
2021-05-23,5,9868,123,2641,1041,1,0,13674
2021-05-23,6,9951,123,2793,821,8,0,13696
2021-05-23,7,9946,125,2887,1291,60,0,14309
2021-05-23,8,9939,132,3034,1826,111,0,15042
2021-05-23,9,9995,195,3117,1863,197,0,15367
2021-05-23,10,9997,311,3303,1819,257,0,15687
2021-05-23,11,9998,498,3411,1265,294,0,15466
2021-05-23,12,9995,660,3720,967,305,0,15647
2021-05-23,13,10001,694,3611,895,300,0,15501
2021-05-23,14,10011,723,3429,1045,305,21,15534
2021-05-23,15,9982,844,3359,1099,289,53,15626
2021-05-23,16,10001,846,3322,1183,240,54,15646
2021-05-23,17,10020,842,3624,1559,179,55,16279
2021-05-23,18,10021,510,4389,1505,86,58,16569
2021-05-23,19,10019,345,4320,1229,27,55,15995
2021-05-23,20,10018,306,4356,1094,4,69,15847
2021-05-23,21,10018,143,4555,1057,0,85,15858
2021-05-23,22,10016,121,3849,1190,0,65,15241
2021-05-23,23,10049,121,3505,1223,0,56,14954
2021-05-23,24,10051,121,3325,1050,0,56,14603
2021-05-24,1,10053,121,3091,662,0,56,13983
2021-05-24,2,10053,121,2773,451,0,56,13454
2021-05-24,3,10044,121,2680,281,0,56,13182
2021-05-24,4,9804,121,2760,458,0,56,13199
2021-05-24,5,9794,121,2666,1028,2,56,13667
2021-05-24,6,9800,121,2766,862,16,56,13621
2021-05-24,7,9804,121,2881,839,71,56,13772
2021-05-24,8,9796,121,2995,897,166,56,14031
2021-05-24,9,10001,121,3066,452,259,56,13955
2021-05-24,10,10046,121,3254,416,322,56,14215
2021-05-24,11,10049,121,3531,397,357,56,14511
2021-05-24,12,10055,121,3506,411,391,56,14540
2021-05-24,13,10057,124,3702,294,406,56,14639
2021-05-24,14,10023,153,3811,309,407,56,14759
2021-05-24,15,10021,194,3750,359,387,56,14767
2021-05-24,16,10020,307,4226,380,312,56,15301
2021-05-24,17,10017,310,4844,361,210,56,15798
2021-05-24,18,10013,312,5031,371,102,56,15885
2021-05-24,19,10008,315,4779,395,24,56,15577
2021-05-24,20,10009,305,4327,455,5,56,15157
2021-05-24,21,10007,304,4069,691,0,9,15080
2021-05-24,22,10013,158,3740,795,0,0,14706
2021-05-24,23,10012,121,3306,817,0,0,14256
2021-05-24,24,10014,121,3209,730,0,0,14074
2021-05-25,1,10015,121,2735,771,0,0,13642
2021-05-25,2,10024,121,2703,388,0,0,13236
2021-05-25,3,10020,121,2678,333,0,0,13152
2021-05-25,4,10022,72,2636,372,0,9,13111
2021-05-25,5,10026,95,2683,746,1,15,13566
2021-05-25,6,10030,129,2804,1257,6,26,14252
2021-05-25,7,10024,172,3095,1427,45,30,14793
2021-05-25,8,10019,306,3750,1676,131,36,15918
2021-05-25,9,10017,310,3853,1681,189,38,16088
2021-05-25,10,10007,312,4118,2022,239,53,16751
2021-05-25,11,9999,460,3829,2440,292,55,17075
2021-05-25,12,9987,536,3846,2854,375,54,17652
2021-05-25,13,9984,708,3996,3105,334,48,18175
2021-05-25,14,9984,835,4389,3227,309,29,18773
2021-05-25,15,9976,876,4663,3226,238,43,19022
2021-05-25,16,10008,959,4723,3096,179,34,18999
2021-05-25,17,10018,1110,5488,3004,142,30,19792
2021-05-25,18,10019,1226,5517,2904,78,31,19775
2021-05-25,19,10019,1222,4849,2783,33,48,18954
2021-05-25,20,10014,1135,4684,2683,6,72,18594
2021-05-25,21,10015,833,4520,2842,0,85,18295
2021-05-25,22,10020,476,4069,3192,0,85,17842
2021-05-25,23,10024,349,3459,3246,0,76,17154
2021-05-25,24,10031,192,2903,3148,0,57,16331
2021-05-26,1,10036,176,2657,2977,0,16,15862
2021-05-26,2,10044,190,2724,2368,0,16,15342
2021-05-26,3,10042,190,2669,2136,0,15,15052
2021-05-26,4,10039,190,2600,2147,0,15,14991
2021-05-26,5,10038,189,2752,2220,1,19,15219
2021-05-26,6,10033,206,2997,2124,10,30,15400
2021-05-26,7,10030,263,3394,2232,33,33,15985
2021-05-26,8,10028,387,3941,2553,110,33,17052
2021-05-26,9,10022,471,4713,2249,169,32,17656
2021-05-26,10,10019,728,4876,2209,146,33,18011
2021-05-26,11,10012,736,4288,2366,161,47,17610
2021-05-26,12,10010,797,4238,2444,152,48,17689
2021-05-26,13,10012,806,4161,2307,189,42,17517
2021-05-26,14,10011,800,3939,2510,228,32,17520
2021-05-26,15,10006,804,4258,2827,187,32,18114
2021-05-26,16,9999,803,4250,2725,196,32,18005
2021-05-26,17,9997,802,4450,2802,139,32,18222
2021-05-26,18,9996,308,4780,2823,76,32,18015
2021-05-26,19,10000,185,4808,2668,31,32,17724
2021-05-26,20,10005,183,4525,2685,4,32,17434
2021-05-26,21,10005,179,3996,2580,0,31,16791
2021-05-26,22,10009,178,3827,2028,0,31,16073
2021-05-26,23,10012,177,3363,1675,0,20,15247
2021-05-26,24,10017,179,2730,1666,0,16,14608
2021-05-27,1,10018,179,2663,1329,0,16,14205
2021-05-27,2,10014,179,2645,1085,0,16,13939
2021-05-27,3,10021,179,2747,819,0,16,13782
2021-05-27,4,10021,179,2719,764,0,16,13699
2021-05-27,5,10026,179,2804,956,1,18,13984
2021-05-27,6,10025,179,2970,825,12,30,14041
2021-05-27,7,10028,179,3828,744,65,32,14876
2021-05-27,8,10027,180,4223,532,184,32,15178
2021-05-27,9,10024,214,4298,218,288,32,15074
2021-05-27,10,10026,244,4285,163,350,32,15100
2021-05-27,11,10030,219,3709,264,334,32,14588
2021-05-27,12,10032,282,4189,504,369,32,15408
2021-05-27,13,10030,205,3883,733,402,32,15285
2021-05-27,14,10034,165,3768,823,414,32,15236
2021-05-27,15,10039,161,3731,995,368,32,15326
2021-05-27,16,10043,162,3913,1385,312,33,15848
2021-05-27,17,10037,162,4415,1278,223,32,16147
2021-05-27,18,10049,162,4618,1579,94,32,16534
2021-05-27,19,10049,163,4704,1272,28,32,16248
2021-05-27,20,10049,176,5392,961,2,32,16612
2021-05-27,21,10046,184,4910,892,0,32,16064
2021-05-27,22,10048,162,4192,880,0,32,15314
2021-05-27,23,10050,162,3381,1322,0,20,14935
2021-05-27,24,10048,163,3051,1566,0,16,14844
2021-05-28,1,10051,162,2586,1849,0,16,14664
2021-05-28,2,10052,161,2628,1499,0,15,14355
2021-05-28,3,10051,162,2656,1352,0,15,14236
2021-05-28,4,10061,164,2703,1300,0,15,14243
2021-05-28,5,10062,165,2728,1601,1,17,14574
2021-05-28,6,10047,166,2714,2221,7,26,15181
2021-05-28,7,10053,166,3088,2750,19,32,16108
2021-05-28,8,10044,166,3327,2740,40,31,16348
2021-05-28,9,10045,164,3121,3341,65,31,16767
2021-05-28,10,10046,164,3234,3326,96,31,16897
2021-05-28,11,10042,163,3282,3243,113,32,16875
2021-05-28,12,10049,163,3247,3147,111,32,16749
2021-05-28,13,10051,162,3109,3105,136,32,16595
2021-05-28,14,10044,160,3183,2783,170,32,16372
2021-05-28,15,10038,162,3120,2563,174,32,16089
2021-05-28,16,10037,159,3142,2878,148,32,16396
2021-05-28,17,10040,160,3267,2921,114,32,16534
2021-05-28,18,10042,162,3330,2663,62,32,16291
2021-05-28,19,10038,164,3867,1786,21,33,15909
2021-05-28,20,10034,165,4149,2198,6,33,16585
2021-05-28,21,10024,165,4114,2640,0,46,16989
2021-05-28,22,10021,165,3219,2670,0,77,16152
2021-05-28,23,10019,166,2879,2324,0,69,15457
2021-05-28,24,10013,166,2670,1914,0,52,14815
2021-05-29,1,10007,166,2655,1690,0,52,14570
2021-05-29,2,10006,166,2614,1247,0,52,14085
2021-05-29,3,10008,166,2655,1095,0,54,13978
2021-05-29,4,10008,166,2699,1035,0,54,13962
2021-05-29,5,10009,167,2610,1408,2,51,14247
2021-05-29,6,10010,166,2582,1666,15,51,14490
2021-05-29,7,10006,165,2624,1886,65,50,14796
2021-05-29,8,9999,165,2705,1905,161,50,14985
2021-05-29,9,9998,165,2761,1948,282,50,15204
2021-05-29,10,10005,165,2903,1707,356,50,15186
2021-05-29,11,10007,165,2869,1813,399,50,15303
2021-05-29,12,10005,164,2853,1802,420,50,15294
2021-05-29,13,10000,162,2842,1629,409,50,15092
2021-05-29,14,10000,162,2841,1478,387,50,14918
2021-05-29,15,10000,162,2894,1321,412,50,14839
2021-05-29,16,9995,160,3175,1393,381,50,15154
2021-05-29,17,10008,159,3659,1828,241,50,15945
2021-05-29,18,10027,129,3848,1871,112,52,16039
2021-05-29,19,10029,128,4306,1421,34,51,15969
2021-05-29,20,10032,128,4541,1054,8,51,15814
2021-05-29,21,10034,134,4270,948,0,51,15437
2021-05-29,22,10046,178,4338,813,0,9,15384
2021-05-29,23,10044,145,3763,737,0,0,14689
2021-05-29,24,10047,129,3367,775,0,0,14318
2021-05-30,1,10046,130,3208,745,0,0,14129
2021-05-30,2,10050,130,3077,783,0,0,14040
2021-05-30,3,10046,126,2926,862,0,0,13960
2021-05-30,4,10053,121,2746,755,0,0,13675
2021-05-30,5,10050,121,2822,787,2,0,13782
2021-05-30,6,10076,122,2779,744,14,0,13735
2021-05-30,7,10083,126,3082,596,67,7,13961
2021-05-30,8,10082,127,3276,299,190,10,13984
2021-05-30,9,10076,127,3451,239,315,23,14231
2021-05-30,10,10079,126,3216,220,391,25,14057
2021-05-30,11,10078,126,3236,492,422,27,14381
2021-05-30,12,10076,125,3428,567,421,28,14645
2021-05-30,13,10073,124,3397,619,406,29,14648
2021-05-30,14,10013,126,3254,547,432,30,14402
2021-05-30,15,10067,126,3307,529,421,30,14480
2021-05-30,16,10066,121,3801,571,363,29,14951
2021-05-30,17,10068,122,4488,685,245,29,15637
2021-05-30,18,10069,122,4845,564,126,29,15755
2021-05-30,19,10065,121,4635,392,33,29,15275
2021-05-30,20,10067,122,4638,391,7,29,15254
2021-05-30,21,10065,123,4169,359,0,23,14739
2021-05-30,22,10071,128,4258,300,0,27,14784
2021-05-30,23,10078,138,3893,277,0,28,14414
2021-05-30,24,10077,127,3066,288,0,25,13583
2021-05-31,1,10080,127,3044,511,0,30,13792
2021-05-31,2,10084,126,3132,464,0,41,13847
2021-05-31,3,10085,128,3039,570,0,38,13860
2021-05-31,4,10088,128,3037,537,0,25,13815
2021-05-31,5,10086,138,2901,496,1,21,13643
2021-05-31,6,10076,142,2976,388,15,27,13624
2021-05-31,7,10072,146,3720,781,73,37,14829
2021-05-31,8,10074,258,3874,466,160,35,14867
2021-05-31,9,10071,310,4017,458,285,31,15172
2021-05-31,10,10071,308,3780,608,378,31,15176
2021-05-31,11,10066,353,3602,615,415,42,15093
2021-05-31,12,10062,358,3695,659,410,35,15219
2021-05-31,13,10057,419,3539,348,415,32,14810
2021-05-31,14,10051,554,3702,540,393,32,15272
2021-05-31,15,10057,562,3743,1190,383,33,15968
2021-05-31,16,10060,682,3745,964,301,33,15785
2021-05-31,17,10062,671,4515,1157,209,32,16646
2021-05-31,18,10058,664,4863,931,102,32,16650
2021-05-31,19,10059,673,4867,865,30,32,16526
2021-05-31,20,10059,632,4229,993,7,30,15950
2021-05-31,21,10056,668,3979,1045,0,15,15763
2021-05-31,22,10042,731,3457,1161,0,0,15391
2021-05-31,23,10066,264,3306,997,0,0,14633
2021-05-31,24,10070,192,3115,1038,0,15,14430
2021-06-01,1,10067,230,3116,1014,0,16,14443
2021-06-01,2,10071,234,3168,702,0,16,14191
2021-06-01,3,10071,271,3118,726,0,17,14203
2021-06-01,4,10075,318,3226,608,0,18,14245
2021-06-01,5,10076,452,3147,323,1,21,14020
2021-06-01,6,10079,554,3101,317,8,28,14087
2021-06-01,7,10076,674,3852,335,49,31,15017
2021-06-01,8,10072,895,4079,158,132,34,15370
2021-06-01,9,10068,861,3940,146,230,32,15277
2021-06-01,10,10064,809,3518,206,279,32,14908
2021-06-01,11,10064,893,3694,338,326,31,15346
2021-06-01,12,10059,919,3760,456,351,31,15576
2021-06-01,13,10061,956,3542,650,402,35,15646
2021-06-01,14,10063,1123,3311,922,392,32,15843
2021-06-01,15,10066,1288,3394,1019,381,32,16180
2021-06-01,16,10061,1384,3473,1036,316,32,16302
2021-06-01,17,10062,1452,4207,835,232,32,16820
2021-06-01,18,10052,1789,4388,707,113,32,17081
2021-06-01,19,10065,1701,4299,573,31,31,16700
2021-06-01,20,10069,1666,3799,537,7,32,16110
2021-06-01,21,10073,1402,3798,530,0,33,15836
2021-06-01,22,10064,714,3901,494,0,35,15208
2021-06-01,23,10078,555,3594,435,0,21,14683
2021-06-01,24,10080,481,2960,281,0,16,13818
2021-06-02,1,10078,257,2812,299,0,15,13461
2021-06-02,2,10081,193,2954,445,0,15,13688
2021-06-02,3,10072,194,3002,402,0,15,13685
2021-06-02,4,10064,193,3097,411,0,16,13781
2021-06-02,5,10078,194,3138,393,3,19,13825
2021-06-02,6,10078,226,3340,366,22,26,14058
2021-06-02,7,10080,239,3647,369,73,31,14439
2021-06-02,8,10075,288,4140,264,152,31,14950
2021-06-02,9,10077,686,4353,152,230,31,15529
2021-06-02,10,10073,962,3739,128,275,31,15208
2021-06-02,11,10069,985,3513,233,362,32,15194
2021-06-02,12,10067,899,3682,364,377,32,15421
2021-06-02,13,10067,871,3576,435,369,31,15349
2021-06-02,14,10067,905,3704,514,307,31,15528
2021-06-02,15,9915,1268,3823,597,258,31,15892
2021-06-02,16,10045,1643,4030,682,200,31,16631
2021-06-02,17,10057,1657,4737,647,82,29,17209
2021-06-02,18,10058,1535,4795,779,50,31,17248
2021-06-02,19,10059,1237,4096,1014,14,32,16452
2021-06-02,20,10060,1223,3940,855,3,32,16113
2021-06-02,21,10061,1042,3653,1113,0,31,15900
2021-06-02,22,10065,688,3485,1121,0,31,15390
2021-06-02,23,10064,294,3407,1046,0,27,14838
2021-06-02,24,10068,206,3180,1154,0,17,14625
2021-06-03,1,10068,208,2991,932,0,15,14214
2021-06-03,2,10073,232,3192,751,0,15,14263
2021-06-03,3,10073,321,3293,534,0,16,14237
2021-06-03,4,10074,527,3232,398,0,22,14253
2021-06-03,5,10064,602,3182,300,1,45,14194
2021-06-03,6,10063,612,3280,269,3,51,14278
2021-06-03,7,10063,646,3603,285,13,55,14665
2021-06-03,8,10061,884,3978,265,41,56,15285
2021-06-03,9,10060,1017,3822,275,76,56,15306
2021-06-03,10,10058,873,3755,278,116,49,15129
2021-06-03,11,10059,1155,3664,270,152,49,15349
2021-06-03,12,10056,1491,3581,338,184,56,15706
2021-06-03,13,10050,1353,3653,308,230,58,15652
2021-06-03,14,10047,1603,3636,290,269,58,15903
2021-06-03,15,10045,1329,3742,297,290,60,15763
2021-06-03,16,10049,1654,4118,250,229,77,16377
2021-06-03,17,10045,1785,4255,283,160,106,16634
2021-06-03,18,10043,1677,4534,294,108,107,16763
2021-06-03,19,10037,1554,4464,366,47,92,16560
2021-06-03,20,10033,1662,4392,519,11,100,16717
2021-06-03,21,10029,1393,4109,817,0,130,16478
2021-06-03,22,10022,847,3680,1068,0,132,15749
2021-06-03,23,10034,338,3389,1213,0,94,15068
2021-06-03,24,10039,268,3385,1159,0,27,14878
2021-06-04,1,10043,284,3038,1235,0,15,14615
2021-06-04,2,10049,298,2995,1278,0,15,14635
2021-06-04,3,10053,397,2986,1283,0,15,14734
2021-06-04,4,10056,748,3034,1176,0,17,15031
2021-06-04,5,10049,991,2953,1039,2,20,15054
2021-06-04,6,10052,1211,3018,665,8,27,14981
2021-06-04,7,10052,1342,3411,581,40,32,15458
2021-06-04,8,10049,1527,3654,598,77,31,15936
2021-06-04,9,10039,1551,3694,572,116,31,16003
2021-06-04,10,10033,1660,3551,509,178,32,15963
2021-06-04,11,10025,2037,3589,501,232,0,16384
2021-06-04,12,10016,2381,3617,603,334,32,16983
2021-06-04,13,10010,2226,3568,967,397,31,17199
2021-06-04,14,10009,2274,3263,1495,395,32,17468
2021-06-04,15,10020,2240,3115,1686,361,32,17454
2021-06-04,16,10022,2240,3511,1690,294,30,17787
2021-06-04,17,10026,2107,4217,1770,220,31,18371
2021-06-04,18,10033,1965,4427,1657,116,31,18229
2021-06-04,19,10038,2246,4478,1445,32,31,18270
2021-06-04,20,10029,1944,3905,1616,6,53,17553
2021-06-04,21,10026,1707,3297,1988,0,48,17066
2021-06-04,22,10029,1021,3268,2400,0,81,16799
2021-06-04,23,10032,565,2872,2500,0,65,16034
2021-06-04,24,10030,519,2768,2133,0,62,15512
2021-06-05,1,10030,262,2730,2267,0,56,15345
2021-06-05,2,10026,197,2761,2211,0,56,15251
2021-06-05,3,10027,196,2765,2000,0,57,15045
2021-06-05,4,10030,196,2948,1699,0,76,14949
2021-06-05,5,10030,173,2948,1800,2,84,15037
2021-06-05,6,10041,170,2798,1942,12,56,15019
2021-06-05,7,10047,180,2918,2067,71,56,15339
2021-06-05,8,10045,190,3134,2381,152,40,15942
2021-06-05,9,10036,280,3631,2378,254,0,16579
2021-06-05,10,10028,427,3696,2202,319,0,16672
2021-06-05,11,10027,883,3958,2136,374,0,17378
2021-06-05,12,10022,1154,3760,2340,360,0,17636
2021-06-05,13,10021,1023,3605,2674,348,0,17671
2021-06-05,14,10023,963,3434,2971,359,0,17750
2021-06-05,15,10024,983,3719,3046,367,0,18139
2021-06-05,16,10023,1045,3810,3162,289,0,18329
2021-06-05,17,10025,1190,4162,3169,182,0,18728
2021-06-05,18,10023,920,4558,2945,107,0,18553
2021-06-05,19,10024,1055,4591,2525,34,0,18229
2021-06-05,20,10014,861,4070,2391,8,0,17344
2021-06-05,21,10018,795,3792,2467,0,1,17073
2021-06-05,22,10021,671,3374,2664,0,17,16747
2021-06-05,23,10020,271,3098,2624,0,49,16062
2021-06-05,24,10022,214,3013,2185,0,57,15491
2021-06-06,1,10030,216,2855,2147,0,56,15304
2021-06-06,2,10039,223,2850,2205,0,56,15373
2021-06-06,3,10042,250,2865,2161,0,50,15368
2021-06-06,4,10044,412,2805,2428,0,0,15689
2021-06-06,5,10039,754,2824,1922,1,0,15540
2021-06-06,6,10041,963,2813,1617,7,0,15441
2021-06-06,7,10042,1030,3002,1373,65,0,15512
2021-06-06,8,10035,1154,3264,1421,157,0,16031
2021-06-06,9,10036,1458,3573,1280,275,19,16641
2021-06-06,10,10027,2087,3493,1247,373,51,17278
2021-06-06,11,10025,2651,3540,1238,400,59,17913
2021-06-06,12,10016,2851,3581,1526,415,52,18441
2021-06-06,13,10023,2687,3726,1878,419,51,18784
2021-06-06,14,10019,2735,3895,2028,413,38,19128
2021-06-06,15,10018,3033,4012,2018,374,0,19455
2021-06-06,16,10018,3906,4378,1981,307,0,20590
2021-06-06,17,10014,4332,4435,1935,226,0,20942
2021-06-06,18,10004,4545,4724,1913,123,0,21309
2021-06-06,19,10013,4493,4566,1743,35,0,20850
2021-06-06,20,10013,4595,4345,1727,7,0,20687
2021-06-06,21,10019,4009,4036,1845,0,0,19909
2021-06-06,22,10021,3265,3574,2042,0,0,18902
2021-06-06,23,10021,2324,3006,2013,0,0,17364
2021-06-06,24,10021,1913,2910,1813,0,0,16657
2021-06-07,1,10026,1458,2955,1863,0,9,16311
2021-06-07,2,10031,1082,2901,1942,0,11,15967
2021-06-07,3,10028,1089,2941,1983,0,16,16057
2021-06-07,4,10032,1247,2901,1796,1,17,15994
2021-06-07,5,10033,1534,2811,1523,2,34,15937
2021-06-07,6,10032,1961,2857,1449,9,86,16394
2021-06-07,7,10030,2344,3231,1192,66,111,16974
2021-06-07,8,10026,3022,3501,926,168,112,17755
2021-06-07,9,10023,4046,3599,920,272,123,18983
2021-06-07,10,10016,4118,3699,1122,340,105,19400
2021-06-07,11,10014,4474,3676,1290,312,99,19865
2021-06-07,12,10016,5067,3807,1643,303,108,20944
2021-06-07,13,10008,5550,3885,1897,324,104,21768
2021-06-07,14,9999,5459,3835,1948,329,102,21672
2021-06-07,15,10005,6059,4211,1771,301,160,22507
2021-06-07,16,10003,5812,4423,1805,262,119,22424
2021-06-07,17,10003,5574,4738,1559,141,95,22110
2021-06-07,18,10009,5802,4808,1271,70,102,22062
2021-06-07,19,10008,5872,4714,1090,31,101,21816
2021-06-07,20,10012,5874,4496,953,5,96,21436
2021-06-07,21,10011,5920,4145,785,0,94,20955
2021-06-07,22,10012,5507,3649,757,0,79,20004
2021-06-07,23,10012,4166,3388,798,0,74,18438
2021-06-07,24,10024,2811,3090,747,0,79,16751
2021-06-08,1,10026,2694,2943,713,0,99,16475
2021-06-08,2,10027,3029,2756,361,0,69,16242
2021-06-08,3,10029,2950,2823,357,0,75,16234
2021-06-08,4,10025,2869,2996,493,1,76,16460
2021-06-08,5,10028,3107,2934,444,2,72,16587
2021-06-08,6,10031,3398,3024,265,6,82,16806
2021-06-08,7,10026,3781,3163,229,28,89,17316
2021-06-08,8,10024,4128,3495,212,79,111,18049
2021-06-08,9,10018,5048,3580,217,123,92,19078
2021-06-08,10,10013,5470,3707,172,199,89,19650
2021-06-08,11,10010,5539,3789,185,181,88,19792
2021-06-08,12,10017,6079,3934,190,257,91,20568
2021-06-08,13,10012,6248,4217,241,256,132,21106
2021-06-08,14,10009,6101,4230,266,284,90,20980
2021-06-08,15,10015,6102,4403,414,232,78,21244
2021-06-08,16,10018,5991,4413,593,233,79,21327
2021-06-08,17,10021,5525,4544,715,114,85,21004
2021-06-08,18,10020,5748,4465,461,61,89,20844
2021-06-08,19,10016,5879,4170,287,36,86,20474
2021-06-08,20,10014,5927,3825,175,7,103,20051
2021-06-08,21,10008,5954,3555,268,0,109,19894
2021-06-08,22,10013,5155,3334,372,0,139,19013
2021-06-08,23,10018,3941,3366,342,0,129,17796
2021-06-08,24,10019,2672,2952,180,0,222,16045
2021-06-09,1,10025,2009,3081,269,0,212,15596
2021-06-09,2,10026,2051,2639,276,0,204,15196
2021-06-09,3,10021,2315,2482,217,0,179,15214
2021-06-09,4,10022,2332,2614,294,0,143,15405
2021-06-09,5,10031,2423,2552,99,2,104,15211
2021-06-09,6,10026,2533,2673,309,9,38,15588
2021-06-09,7,10030,2948,3142,487,69,31,16707
2021-06-09,8,10030,4411,3214,412,156,32,18255
2021-06-09,9,10024,5240,3324,404,263,32,19287
2021-06-09,10,10022,5340,3469,414,287,49,19581
2021-06-09,11,10024,5688,3708,422,346,86,20274
2021-06-09,12,10023,5938,4049,420,388,153,20971
2021-06-09,13,10017,5968,3560,423,413,98,20479
2021-06-09,14,10021,5856,3981,508,377,86,20829
2021-06-09,15,10023,5544,4160,640,318,95,20780
2021-06-09,16,10020,5523,4340,683,295,98,20959
2021-06-09,17,10025,5942,4606,691,194,137,21595
2021-06-09,18,10037,6253,4512,747,104,227,21880
2021-06-09,19,10040,6180,4143,631,30,215,21239
2021-06-09,20,10039,6233,3737,635,7,169,20820
2021-06-09,21,10039,5582,3422,625,0,121,19789
2021-06-09,22,10036,5139,3161,827,0,89,19252
2021-06-09,23,10037,3859,3031,938,0,79,17944
2021-06-09,24,10032,2935,2598,558,0,93,16216
2021-06-10,1,10034,1893,2765,864,0,98,15654
2021-06-10,2,10039,1473,2845,1039,0,62,15458
2021-06-10,3,10044,1481,2601,1090,0,17,15233
2021-06-10,4,10042,1476,2424,1052,0,17,15011
2021-06-10,5,10048,1332,2445,806,1,23,14655
2021-06-10,6,10030,1354,2513,1177,9,33,15116
2021-06-10,7,10014,1611,2910,1496,61,51,16143
2021-06-10,8,10011,1828,3357,1508,166,84,16954
2021-06-10,9,10015,2052,3266,1583,252,86,17254
2021-06-10,10,10021,1962,3267,1478,341,88,17157
2021-06-10,11,10028,2073,3439,1319,372,88,17319
2021-06-10,12,10023,2982,3529,1042,392,88,18056
2021-06-10,13,10013,2730,3774,1030,375,86,18008
2021-06-10,14,10017,2809,3892,1014,388,88,18208
2021-06-10,15,10022,2784,3877,1146,375,88,18292
2021-06-10,16,10019,2768,4107,1283,325,89,18591
2021-06-10,17,10012,3327,4379,1203,231,91,19243
2021-06-10,18,10009,3756,3887,1223,119,90,19084
2021-06-10,19,10007,3318,3670,1447,30,87,18559
2021-06-10,20,10001,2844,3087,1676,6,48,17662
2021-06-10,21,9991,2454,2957,1863,0,31,17296
2021-06-10,22,10002,1782,2713,1823,0,31,16351
2021-06-10,23,10005,1025,2674,1774,0,23,15501
2021-06-10,24,10014,742,2709,1752,0,18,15235
2021-06-11,1,10022,431,2928,1557,0,17,14955
2021-06-11,2,10022,346,2633,1543,0,16,14560
2021-06-11,3,10020,586,2634,1123,0,18,14381
2021-06-11,4,10015,885,2639,1019,0,17,14575
2021-06-11,5,10012,912,2622,1177,1,19,14743
2021-06-11,6,10020,1018,2886,1031,4,27,14986
2021-06-11,7,10016,1436,3054,691,39,31,15267
2021-06-11,8,10016,1645,3346,465,120,32,15624
2021-06-11,9,10003,1990,3592,347,205,31,16168
2021-06-11,10,9989,2007,3745,271,302,31,16345
2021-06-11,11,9985,2061,3748,269,393,32,16488
2021-06-11,12,9974,2453,3719,251,376,32,16805
2021-06-11,13,9974,2508,3890,254,331,40,16997
2021-06-11,14,9972,2773,3846,408,286,40,17325
2021-06-11,15,9969,2973,3953,466,253,33,17647
2021-06-11,16,9984,3085,3881,654,229,33,17866
2021-06-11,17,9995,3132,4276,766,163,33,18365
2021-06-11,18,10013,3611,4363,898,88,40,19013
2021-06-11,19,10014,3535,4239,839,25,69,18721
2021-06-11,20,10005,3606,3881,722,6,84,18304
2021-06-11,21,9991,2878,3492,525,1,85,16972
2021-06-11,22,9984,2061,3162,559,1,85,15852
2021-06-11,23,9981,1256,3471,465,1,77,15251
2021-06-11,24,9985,896,3361,514,1,37,14794
2021-06-12,1,9991,431,3223,606,1,0,14252
2021-06-12,2,9993,242,3249,473,1,0,13958
2021-06-12,3,9999,246,3077,413,1,0,13736
2021-06-12,4,9999,176,3133,412,2,0,13722
2021-06-12,5,10002,166,3103,487,4,0,13762
2021-06-12,6,10011,156,2875,497,17,0,13556
2021-06-12,7,10009,186,3316,297,71,0,13879
2021-06-12,8,10005,267,3912,181,161,0,14526
2021-06-12,9,9997,357,3792,172,275,0,14593
2021-06-12,10,9993,408,3631,211,372,0,14615
2021-06-12,11,9988,746,3753,218,391,0,15096
2021-06-12,12,9999,959,3789,141,403,0,15291
2021-06-12,13,10004,1368,3850,164,377,0,15763
2021-06-12,14,10003,1554,3887,132,386,0,15962
2021-06-12,15,9999,1806,3762,94,364,0,16025
2021-06-12,16,9993,1970,4063,107,292,0,16425
2021-06-12,17,9989,2302,4558,103,197,0,17149
2021-06-12,18,9987,2493,4396,112,97,0,17085
2021-06-12,19,9985,2537,4341,149,36,0,17048
2021-06-12,20,9985,2362,4001,164,7,0,16519
2021-06-12,21,9986,2152,3842,161,1,0,16142
2021-06-12,22,9985,1877,3588,200,1,0,15651
2021-06-12,23,9987,1079,3514,212,1,0,14793
2021-06-12,24,9997,523,3392,279,1,0,14192
2021-06-13,1,9997,395,3080,358,1,0,13831
2021-06-13,2,10008,197,3049,266,1,0,13521
2021-06-13,3,10015,162,3234,165,1,0,13577
2021-06-13,4,10011,243,2957,215,1,0,13427
2021-06-13,5,10008,399,3073,134,3,0,13617
2021-06-13,6,10008,571,2816,95,11,0,13501
2021-06-13,7,10008,588,2749,64,27,0,13436
2021-06-13,8,10009,700,3236,55,152,0,14152
2021-06-13,9,10010,1116,3342,147,265,0,14880
2021-06-13,10,10009,1615,3500,306,340,0,15770
2021-06-13,11,10006,1833,3809,440,371,0,16459
2021-06-13,12,10002,2478,3904,641,375,0,17400
2021-06-13,13,9997,2488,3895,795,341,0,17516
2021-06-13,14,9996,2402,3799,1106,353,0,17656
2021-06-13,15,9997,2641,3460,1223,305,0,17626
2021-06-13,16,9997,2655,3578,1387,257,0,17874
2021-06-13,17,10001,2632,3812,1515,166,0,18126
2021-06-13,18,10005,2612,4123,1477,100,0,18317
2021-06-13,19,10004,2349,4036,1216,39,0,17644
2021-06-13,20,10004,1935,4070,976,9,0,16994
2021-06-13,21,9991,1882,3973,767,1,0,16614
2021-06-13,22,9996,1446,3614,567,1,0,15624
2021-06-13,23,9988,904,3187,578,1,0,14658
2021-06-13,24,9985,405,3060,541,1,0,13992
2021-06-14,1,9989,210,3184,669,1,0,14053
2021-06-14,2,9989,320,2752,786,1,0,13848
2021-06-14,3,9985,325,2846,400,1,0,13557
2021-06-14,4,9990,415,2865,664,1,0,13935
2021-06-14,5,9995,778,2821,663,3,0,14260
2021-06-14,6,10001,1221,2751,638,13,0,14624
2021-06-14,7,10003,1577,2892,662,35,0,15169
2021-06-14,8,10004,1856,3021,789,60,0,15730
2021-06-14,9,10009,2107,3188,438,145,0,15887
2021-06-14,10,10023,2490,3215,344,169,0,16241
2021-06-14,11,10027,2742,3168,161,71,0,16169
2021-06-14,12,10037,2893,3267,178,195,0,16570
2021-06-14,13,10039,2681,3302,615,315,0,16952
2021-06-14,14,10027,2628,3164,819,261,0,16899
2021-06-14,15,10013,2654,3150,848,248,0,16913
2021-06-14,16,10026,2601,3248,536,251,0,16662
2021-06-14,17,10013,2234,3589,835,171,0,16842
2021-06-14,18,10018,1875,3801,1131,88,0,16913
2021-06-14,19,10024,1809,3638,980,30,0,16481
2021-06-14,20,10016,1806,3303,744,9,0,15878
2021-06-14,21,10022,1800,3225,846,2,0,15895
2021-06-14,22,10024,1297,2886,940,1,0,15148
2021-06-14,23,10074,981,2695,825,1,0,14576
2021-06-14,24,10134,287,2653,1161,1,0,14236
2021-06-15,1,10148,196,2686,1112,1,0,14143
2021-06-15,2,10164,207,2561,1127,1,0,14060
2021-06-15,3,10171,319,2543,823,1,0,13857
2021-06-15,4,10171,492,2565,446,1,0,13675
2021-06-15,5,10165,615,2593,577,2,0,13952
2021-06-15,6,10175,613,2591,929,10,0,14318
2021-06-15,7,10164,613,2751,903,52,0,14483
2021-06-15,8,10159,618,2830,1276,129,0,15012
2021-06-15,9,10158,626,2854,1417,233,0,15288
2021-06-15,10,10159,669,2976,1727,293,0,15824
2021-06-15,11,10172,691,2974,1827,316,0,15980
2021-06-15,12,10224,367,3214,1651,378,0,15834
2021-06-15,13,10292,334,3163,2044,383,0,16216
2021-06-15,14,10313,542,3154,1913,405,0,16327
2021-06-15,15,10319,781,3135,1804,397,0,16436
2021-06-15,16,10322,916,3281,2065,329,0,16913
2021-06-15,17,10319,883,3674,2093,246,0,17215
2021-06-15,18,10320,847,3799,2034,132,0,17132
2021-06-15,19,10323,985,3829,2049,37,3,17226
2021-06-15,20,10317,989,3701,1814,9,8,16838
2021-06-15,21,10316,781,3578,1716,1,0,16392
2021-06-15,22,10309,447,2923,1698,1,0,15378
2021-06-15,23,10334,231,2608,1512,1,0,14686
2021-06-15,24,10338,195,2520,1264,1,0,14318
2021-06-16,1,10342,206,2513,1075,1,0,14137
2021-06-16,2,10349,317,2514,1151,1,0,14332
2021-06-16,3,10351,443,2506,879,1,0,14180
2021-06-16,4,10348,628,2571,554,2,0,14103
2021-06-16,5,10122,633,2555,391,3,0,13704
2021-06-16,6,10097,667,2628,717,13,0,14122
2021-06-16,7,10231,956,3165,417,70,0,14839
2021-06-16,8,10334,1211,3357,134,198,0,15234
2021-06-16,9,10336,1133,3192,113,324,0,15098
2021-06-16,10,10323,668,3217,288,397,0,14893
2021-06-16,11,10330,622,3158,573,420,0,15103
2021-06-16,12,10324,422,3197,841,428,0,15212
2021-06-16,13,10326,653,3022,1125,431,0,15557
2021-06-16,14,10324,652,2978,965,408,0,15327
2021-06-16,15,10325,690,2994,989,375,0,15373
2021-06-16,16,10327,823,3264,1111,305,0,15830
2021-06-16,17,10333,852,3773,1198,246,0,16402
2021-06-16,18,10366,876,4279,1139,139,0,16799
2021-06-16,19,10392,867,4113,798,38,0,16208
2021-06-16,20,10429,410,4120,553,8,0,15520
2021-06-16,21,10476,528,3283,391,1,0,14679
2021-06-16,22,10470,417,3253,485,1,0,14626
2021-06-16,23,10482,419,2645,444,1,0,13991
2021-06-16,24,10480,234,2645,420,1,0,13780
2021-06-17,1,10483,216,2551,373,1,0,13624
2021-06-17,2,10497,229,2569,283,1,0,13579
2021-06-17,3,10275,271,2657,362,1,0,13566
2021-06-17,4,10259,451,2634,415,2,0,13761
2021-06-17,5,10067,582,2640,328,3,0,13620
2021-06-17,6,9956,740,3105,365,14,0,14180
2021-06-17,7,10364,788,3086,393,71,0,14702
2021-06-17,8,10501,726,3265,271,193,0,14956
2021-06-17,9,10497,996,3761,268,311,7,15840
2021-06-17,10,10486,1191,3406,382,383,25,15873
2021-06-17,11,10493,1122,3089,589,418,31,15742
2021-06-17,12,10489,1515,3078,897,423,30,16432
2021-06-17,13,10476,1505,2954,791,420,30,16176
2021-06-17,14,10470,1335,2955,826,416,30,16032
2021-06-17,15,10477,1359,3008,1131,397,30,16402
2021-06-17,16,10488,1394,3226,1093,332,38,16571
2021-06-17,17,10491,1746,3612,1201,253,63,17366
2021-06-17,18,10496,1555,4214,1224,132,81,17702
2021-06-17,19,10505,1424,4387,1122,35,82,17555
2021-06-17,20,10511,1000,4110,1309,7,81,17018
2021-06-17,21,10517,782,3448,1982,1,81,16811
2021-06-17,22,10504,451,2863,2073,1,81,15973
2021-06-17,23,10518,397,2505,1823,1,31,15275
2021-06-17,24,10528,226,2491,1633,1,14,14893
2021-06-18,1,10534,200,2508,1588,1,14,14845
2021-06-18,2,10529,203,2483,1567,1,14,14797
2021-06-18,3,10531,191,2498,1287,1,14,14522
2021-06-18,4,10530,191,2585,1160,1,15,14482
2021-06-18,5,10516,192,2470,1673,1,19,14871
2021-06-18,6,10502,191,2447,2453,17,27,15637
2021-06-18,7,10506,193,2738,2086,41,31,15595
2021-06-18,8,10500,208,2786,2679,68,31,16272
2021-06-18,9,10486,377,2836,2570,109,34,16412
2021-06-18,10,10483,629,2777,2723,140,38,16790
2021-06-18,11,10484,891,2859,2666,115,34,17049
2021-06-18,12,10481,865,2717,2620,132,40,16855
2021-06-18,13,10343,1035,2782,2254,181,31,16626
2021-06-18,14,10316,1084,2923,2133,187,31,16674
2021-06-18,15,10320,1226,3146,2559,188,32,17471
2021-06-18,16,10362,1224,3437,2290,184,31,17528
2021-06-18,17,10499,917,3728,2370,152,32,17698
2021-06-18,18,10511,813,3950,2527,81,31,17913
2021-06-18,19,10515,931,3941,2272,30,31,17720
2021-06-18,20,10509,1168,3897,1916,8,30,17528
2021-06-18,21,10510,1182,3467,2090,1,30,17280
2021-06-18,22,10513,859,2943,2196,1,31,16543
2021-06-18,23,10523,441,2620,2324,1,21,15930
2021-06-18,24,10529,387,2492,2068,1,11,15488
2021-06-19,1,10519,334,2445,1818,1,8,15125
2021-06-19,2,10512,203,2564,1492,1,0,14772
2021-06-19,3,10515,197,2494,1316,1,0,14523
2021-06-19,4,10529,193,2435,1183,1,0,14341
2021-06-19,5,10527,193,2471,549,2,3,13745
2021-06-19,6,10522,198,2563,718,10,1,14012
2021-06-19,7,10524,196,2619,714,50,1,14104
2021-06-19,8,10515,292,2967,874,153,0,14801
2021-06-19,9,10513,789,3899,713,234,0,16148
2021-06-19,10,10517,1144,3104,1138,303,0,16206
2021-06-19,11,10510,1256,2688,1445,336,1,16236
2021-06-19,12,10507,1608,2750,1610,353,10,16838
2021-06-19,13,10513,1689,2921,1246,323,39,16731
2021-06-19,14,10512,2079,3418,1187,271,54,17521
2021-06-19,15,10513,2316,3092,808,277,53,17059
2021-06-19,16,10528,2325,3207,354,133,51,16598
2021-06-19,17,10553,2329,3278,322,111,53,16646
2021-06-19,18,10570,2326,3561,232,49,54,16792
2021-06-19,19,10573,1835,3930,462,43,54,16897
2021-06-19,20,10567,1310,3923,429,12,23,16264
2021-06-19,21,10563,1029,3688,445,1,0,15726
2021-06-19,22,10548,474,3293,578,1,0,14894
2021-06-19,23,10533,392,2738,467,1,0,14131
2021-06-19,24,10538,231,2562,452,1,0,13784
2021-06-20,1,10495,197,2624,345,1,0,13662
2021-06-20,2,10304,241,2809,332,1,0,13687
2021-06-20,3,10238,217,2559,309,1,0,13324
2021-06-20,4,10020,211,2874,244,1,0,13350
2021-06-20,5,10030,202,2733,191,3,0,13159
2021-06-20,6,10032,219,2920,161,15,0,13347
2021-06-20,7,10099,330,2923,157,66,0,13575
2021-06-20,8,10343,629,3179,134,163,0,14448
2021-06-20,9,10572,1008,3157,89,257,0,15083
2021-06-20,10,10574,1717,3185,113,346,0,15935
2021-06-20,11,10564,1995,2978,153,369,0,16059
2021-06-20,12,10557,2294,2838,244,360,0,16293
2021-06-20,13,10552,2346,3043,231,334,0,16506
2021-06-20,14,10554,2417,3212,175,362,0,16720
2021-06-20,15,10507,2506,3470,281,376,0,17140
2021-06-20,16,10526,2714,3755,283,312,0,17590
2021-06-20,17,10537,3565,3954,243,226,0,18525
2021-06-20,18,10543,3753,4020,230,120,0,18666
2021-06-20,19,10546,3345,3977,213,43,0,18124
2021-06-20,20,10547,3694,3700,278,10,0,18229
2021-06-20,21,10548,3189,3583,514,1,0,17835
2021-06-20,22,10548,2493,3398,786,1,0,17226
2021-06-20,23,10557,969,3068,1144,1,0,15739
2021-06-20,24,10561,446,2936,1307,1,0,15251
2021-06-21,1,10562,206,2818,1479,1,5,15071
2021-06-21,2,10564,197,2431,1655,1,16,14864
2021-06-21,3,10569,195,2514,1795,1,16,15090
2021-06-21,4,10565,202,2443,2307,1,17,15535
2021-06-21,5,10552,227,2579,1772,3,20,15153
2021-06-21,6,10546,237,2450,2464,8,30,15735
2021-06-21,7,10533,211,2711,2915,29,32,16431
2021-06-21,8,10513,266,3198,3383,80,32,17472
2021-06-21,9,10502,345,3129,3558,168,32,17734
2021-06-21,10,10505,445,3070,3873,260,32,18185
2021-06-21,11,10505,794,3246,4003,174,31,18753
2021-06-21,12,10511,1222,3511,3996,161,32,19433
2021-06-21,13,10516,1299,3373,3759,249,33,19229
2021-06-21,14,10511,1389,3120,3792,306,32,19150
2021-06-21,15,10502,1598,3330,3817,315,25,19587
2021-06-21,16,10493,1944,3323,3625,244,34,19663
2021-06-21,17,10487,1687,3759,3190,175,55,19353
2021-06-21,18,10477,1595,3994,2674,106,83,18929
2021-06-21,19,10470,1599,3984,2376,35,82,18546
2021-06-21,20,10477,969,3667,2608,11,82,17814
2021-06-21,21,10490,842,3490,2506,0,82,17410
2021-06-21,22,10501,838,3107,2410,0,69,16925
2021-06-21,23,10519,361,2608,2073,0,23,15584
2021-06-21,24,10542,201,2664,1516,0,16,14939
2021-06-22,1,10545,202,2546,1212,0,15,14520
2021-06-22,2,10549,212,2590,868,0,15,14234
2021-06-22,3,10556,213,2588,933,0,15,14305
2021-06-22,4,10559,222,2624,917,0,15,14337
2021-06-22,5,10569,338,2540,807,1,20,14275
2021-06-22,6,10568,475,2653,562,12,31,14301
2021-06-22,7,10563,796,2722,453,47,33,14614
2021-06-22,8,10558,813,2979,501,133,32,15016
2021-06-22,9,10561,812,3132,421,176,32,15134
2021-06-22,10,10563,893,3103,531,248,32,15370
2021-06-22,11,10568,1041,3267,533,263,32,15704
2021-06-22,12,10562,1180,3201,484,239,32,15698
2021-06-22,13,10558,799,3323,401,259,33,15373
2021-06-22,14,10559,682,3515,375,266,32,15429
2021-06-22,15,10560,855,3408,381,257,33,15494
2021-06-22,16,10557,1046,3400,249,113,32,15397
2021-06-22,17,10556,1100,3797,526,208,32,16219
2021-06-22,18,10552,1234,3946,305,107,32,16176
2021-06-22,19,10551,1231,3848,335,38,32,16035
2021-06-22,20,10554,1234,3825,264,9,32,15918
2021-06-22,21,10549,890,3695,260,0,32,15426
2021-06-22,22,10546,495,3120,331,0,33,14525
2021-06-22,23,10545,383,2668,402,0,24,14022
2021-06-22,24,10549,221,2614,537,0,16,13937
2021-06-23,1,10550,201,2478,458,0,16,13703
2021-06-23,2,10551,200,2483,582,0,15,13831
2021-06-23,3,10546,200,2492,520,0,15,13773
2021-06-23,4,10548,199,2576,426,0,16,13765
2021-06-23,5,10548,200,2673,591,2,22,14036
2021-06-23,6,10547,225,2857,524,18,28,14199
2021-06-23,7,10539,211,2766,307,70,35,13928
2021-06-23,8,10535,203,3262,202,179,33,14414
2021-06-23,9,10538,280,3560,198,298,31,14905
2021-06-23,10,10527,224,3263,320,344,31,14709
2021-06-23,11,10519,293,3426,632,323,31,15224
2021-06-23,12,10535,269,3269,1007,346,31,15457
2021-06-23,13,10535,203,3028,1316,337,31,15450
2021-06-23,14,10533,257,3038,1378,398,26,15630
2021-06-23,15,10532,318,3072,1555,381,30,15888
2021-06-23,16,10529,405,3183,1927,328,31,16403
2021-06-23,17,10532,407,3912,2312,229,31,17423
2021-06-23,18,10527,407,3996,2409,117,31,17487
2021-06-23,19,10530,407,4008,2292,40,32,17309
2021-06-23,20,10528,410,3911,2007,8,32,16896
2021-06-23,21,10524,411,3757,1911,0,32,16635
2021-06-23,22,10525,293,3161,2202,0,31,16212
2021-06-23,23,10522,199,2682,2228,0,21,15652
2021-06-23,24,10527,200,2623,1624,0,16,14990
2021-06-24,1,10527,199,2450,1542,0,17,14735
2021-06-24,2,10527,206,2497,1402,0,17,14649
2021-06-24,3,10524,206,2489,1117,0,17,14353
2021-06-24,4,10532,232,2494,1100,0,18,14376
2021-06-24,5,10536,235,2567,1410,2,26,14776
2021-06-24,6,10537,242,2514,1521,9,57,14880
2021-06-24,7,10538,262,2748,1617,55,83,15303
2021-06-24,8,10527,314,2773,2407,158,92,16271
2021-06-24,9,10527,654,2743,2436,224,88,16672
2021-06-24,10,10529,754,2801,2508,335,88,17015
2021-06-24,11,10531,769,2928,2365,382,65,17040
2021-06-24,12,10514,775,3312,2472,388,32,17493
2021-06-24,13,10509,784,3482,2616,382,32,17805
2021-06-24,14,10504,775,3455,2623,370,32,17759
2021-06-24,15,10501,851,4427,2236,308,32,18355
2021-06-24,16,10499,1026,4623,2041,231,38,18458
2021-06-24,17,10484,1148,4310,1860,144,70,18016
2021-06-24,18,10487,1044,4428,1974,67,84,18084
2021-06-24,19,10484,814,4342,1966,39,83,17728
2021-06-24,20,10476,1016,4595,1797,7,82,17973
2021-06-24,21,10468,1119,4125,1796,0,81,17589
2021-06-24,22,10475,977,3408,2120,0,47,17027
2021-06-24,23,10471,716,2753,2527,0,22,16489
2021-06-24,24,10483,309,2574,2447,0,14,15827
2021-06-25,1,10487,195,2524,2425,0,11,15642
2021-06-25,2,10495,198,2533,2311,0,11,15548
2021-06-25,3,10491,200,2618,1959,0,12,15280
2021-06-25,4,10489,200,2587,1905,0,12,15193
2021-06-25,5,10484,206,2576,1727,2,15,15010
2021-06-25,6,10480,229,2488,1802,6,22,15027
2021-06-25,7,10474,324,2627,1775,30,27,15257
2021-06-25,8,10473,502,2913,1996,83,27,15994
2021-06-25,9,10466,731,2764,2025,162,27,16175
2021-06-25,10,10468,778,3280,2168,232,26,16952
2021-06-25,11,10473,1127,3977,2128,284,26,18015
2021-06-25,12,10474,1440,4014,2302,248,26,18504
2021-06-25,13,10472,1295,3766,2527,196,29,18285
2021-06-25,14,10465,1367,3069,2516,161,34,17612
2021-06-25,15,10460,1565,3657,1964,150,33,17829
2021-06-25,16,10461,1599,3731,2370,95,31,18287
2021-06-25,17,10462,1173,4140,2740,75,31,18621
2021-06-25,18,10465,779,4181,2713,45,32,18215
2021-06-25,19,10467,768,3898,2652,18,32,17835
2021-06-25,20,10470,766,3842,2828,4,32,17942
2021-06-25,21,10465,359,3642,3029,0,32,17527
2021-06-25,22,10463,195,2892,3164,0,31,16745
2021-06-25,23,10471,165,2571,3002,0,16,16225
2021-06-25,24,10485,159,2644,2545,0,7,15840
2021-06-26,1,10476,160,2613,2349,0,0,15598
2021-06-26,2,10487,159,2553,2429,0,0,15628
2021-06-26,3,10489,159,2588,2171,0,0,15407
2021-06-26,4,10484,158,2960,1881,0,0,15483
2021-06-26,5,10472,167,3229,1605,0,0,15473
2021-06-26,6,10467,179,2739,1573,3,0,14961
2021-06-26,7,10462,176,2709,1757,14,0,15118
2021-06-26,8,10449,177,3061,1721,42,2,15452
2021-06-26,9,10441,192,3089,1897,75,1,15695
2021-06-26,10,10455,356,3258,1979,90,0,16138
2021-06-26,11,10451,552,3173,2271,145,0,16592
2021-06-26,12,10456,702,3289,2570,237,0,17254
2021-06-26,13,10464,782,3214,2777,189,0,17426
2021-06-26,14,10476,860,3282,2834,160,0,17612
2021-06-26,15,10493,943,3789,2680,156,0,18061
2021-06-26,16,10493,931,3756,2607,132,0,17919
2021-06-26,17,10490,928,3892,2614,108,0,18032
2021-06-26,18,10491,926,3789,2731,71,0,18008
2021-06-26,19,10489,926,3436,2731,32,0,17614
2021-06-26,20,10491,930,3338,2806,3,1,17569
2021-06-26,21,10497,701,3388,3065,0,1,17652
2021-06-26,22,10491,269,2983,3338,0,0,17081
2021-06-26,23,10497,183,2545,3613,0,0,16838
2021-06-26,24,10491,178,2653,3118,0,0,16440
2021-06-27,1,10494,182,2535,3065,0,0,16276
2021-06-27,2,10499,184,2583,3044,0,0,16310
2021-06-27,3,10498,230,2581,2695,0,0,16004
2021-06-27,4,10498,247,2609,2382,0,0,15736
2021-06-27,5,10491,268,2573,2357,2,0,15691
2021-06-27,6,10494,287,2560,2474,6,0,15821
2021-06-27,7,10493,463,2626,2815,48,0,16445
2021-06-27,8,10482,545,2793,3414,133,0,17367
2021-06-27,9,10473,703,3224,3644,220,0,18264
2021-06-27,10,10475,982,3222,3546,301,0,18526
2021-06-27,11,10479,1336,3326,3519,332,0,18992
2021-06-27,12,10475,1800,3511,3462,335,0,19583
2021-06-27,13,10473,2295,3931,3502,336,0,20537
2021-06-27,14,10433,2707,4032,3448,378,1,20999
2021-06-27,15,10484,2866,4020,3487,326,16,21199
2021-06-27,16,10485,3131,4348,3462,280,59,21765
2021-06-27,17,10478,3618,4531,3213,175,118,22133
2021-06-27,18,10475,3712,4556,3111,97,97,22048
2021-06-27,19,10474,4054,4437,2867,40,75,21947
2021-06-27,20,10483,4306,4136,2632,8,106,21671
2021-06-27,21,10495,4259,4105,2262,0,79,21200
2021-06-27,22,10503,4184,3923,2028,0,72,20710
2021-06-27,23,10508,3613,3341,1912,0,82,19456
2021-06-27,24,10506,2653,3249,1853,0,20,18281
2021-06-28,1,10516,1699,3088,1669,0,0,16972
2021-06-28,2,10523,1557,2948,1495,0,13,16536
2021-06-28,3,10519,1496,2924,1326,0,15,16280
2021-06-28,4,10520,1662,2946,1133,0,16,16277
2021-06-28,5,10522,1891,2980,824,2,20,16239
2021-06-28,6,10521,2414,2878,943,6,25,16787
2021-06-28,7,10519,3518,3391,823,57,31,18339
2021-06-28,8,10513,4648,3991,467,136,31,19786
2021-06-28,9,10500,5038,4370,313,242,31,20494
2021-06-28,10,10487,5182,4324,270,314,35,20612
2021-06-28,11,10483,5288,3924,290,302,60,20347
2021-06-28,12,10478,5387,4128,394,314,107,20808
2021-06-28,13,10477,5224,4360,557,362,136,21116
2021-06-28,14,10486,5280,4504,622,361,108,21361
2021-06-28,15,10484,5245,4541,665,339,97,21371
2021-06-28,16,10486,5468,4808,642,286,100,21790
2021-06-28,17,10490,6004,4813,595,233,67,22202
2021-06-28,18,10488,5904,4880,543,124,49,21988
2021-06-28,19,10494,5449,5057,497,41,48,21586
2021-06-28,20,10489,5341,4855,632,9,48,21374
2021-06-28,21,10480,5071,4859,411,0,37,20858
2021-06-28,22,10484,5006,4536,251,0,31,20308
2021-06-28,23,10491,4511,3740,238,0,20,19000
2021-06-28,24,10486,3290,3540,205,0,17,17538
2021-06-29,1,10485,2387,3258,170,0,17,16317
2021-06-29,2,10492,2606,3006,224,0,16,16344
2021-06-29,3,10484,2677,2601,263,0,15,16040
2021-06-29,4,10492,2735,2558,381,0,16,16182
2021-06-29,5,10487,2750,2495,208,1,19,15960
2021-06-29,6,10480,2962,2578,166,4,45,16235
2021-06-29,7,10473,3228,3303,292,52,84,17432
2021-06-29,8,10463,3796,3945,426,156,87,18873
2021-06-29,9,10451,4767,4137,391,255,108,20109
2021-06-29,10,10452,5274,4288,381,314,192,20901
2021-06-29,11,10441,5669,4428,534,364,192,21628
2021-06-29,12,10435,5694,4425,688,368,149,21759
2021-06-29,13,10431,5378,4330,800,328,111,21378
2021-06-29,14,10405,5263,4486,781,286,111,21332
2021-06-29,15,10413,5049,4503,942,249,108,21264
2021-06-29,16,10423,4468,4757,1042,199,106,20995
2021-06-29,17,10431,5357,4826,539,116,104,21373
2021-06-29,18,10432,5131,5002,476,64,129,21234
2021-06-29,19,10432,4331,4826,497,35,101,20222
2021-06-29,20,10424,4208,4303,735,7,101,19778
2021-06-29,21,10409,3647,4019,955,0,90,19120
2021-06-29,22,10404,3381,3725,1140,0,107,18757
2021-06-29,23,10396,2468,3565,1283,0,78,17790
2021-06-29,24,10390,1929,3205,1166,0,27,16717
2021-06-30,1,10392,1605,3185,1201,0,17,16400
2021-06-30,2,10394,1748,3150,1282,0,16,16590
2021-06-30,3,10397,1903,2993,1189,0,17,16499
2021-06-30,4,10399,2170,2944,1059,0,16,16588
2021-06-30,5,10401,2550,2784,543,2,18,16298
2021-06-30,6,10407,2956,2825,549,4,30,16771
2021-06-30,7,10408,3033,3084,533,28,32,17118
2021-06-30,8,10405,3217,3275,685,72,32,17686
2021-06-30,9,10402,3790,3809,709,96,32,18838
2021-06-30,10,10399,4042,3919,704,149,32,19245
2021-06-30,11,10386,4845,3918,769,131,32,20081
2021-06-30,12,10379,5068,3986,754,182,32,20401
2021-06-30,13,10373,5167,4149,914,237,32,20872
2021-06-30,14,10374,5069,4159,783,244,32,20661
2021-06-30,15,10355,5038,4481,927,209,32,21042
2021-06-30,16,10350,4609,4789,932,216,32,20928
2021-06-30,17,10380,4421,4839,978,153,32,20803
2021-06-30,18,10415,4124,5036,694,101,32,20402
2021-06-30,19,10425,4308,4894,537,39,32,20235
2021-06-30,20,10437,3572,4888,341,9,32,19279
2021-06-30,21,10431,3320,4803,256,0,32,18842
2021-06-30,22,10441,2433,4321,296,0,32,17523
2021-06-30,23,10446,2136,3568,234,0,19,16403
2021-06-30,24,10436,1338,3442,242,0,16,15474
2021-07-01,1,10445,510,3083,483,0,19,14540
2021-07-01,2,10448,264,3259,490,0,16,14477
2021-07-01,3,10444,361,2829,537,0,16,14187
2021-07-01,4,10447,657,2873,615,0,16,14608
2021-07-01,5,10448,1047,3175,412,1,17,15100
2021-07-01,6,10449,1296,3225,429,10,29,15438
2021-07-01,7,10441,1382,3142,376,52,53,15446
2021-07-01,8,10434,1569,4044,403,111,65,16626
2021-07-01,9,10426,1663,4077,453,177,66,16862
2021-07-01,10,10417,1779,4192,526,243,66,17223
2021-07-01,11,10421,1680,4013,714,275,66,17169
2021-07-01,12,10428,1888,4056,906,287,65,17630
2021-07-01,13,10429,1585,4081,1112,246,72,17525
2021-07-01,14,10429,1423,3677,1856,223,73,17681
2021-07-01,15,10433,1474,3497,1866,229,74,17573
2021-07-01,16,10433,1069,3631,2169,206,73,17581
2021-07-01,17,10438,919,4032,2440,170,71,18070
2021-07-01,18,10439,961,4037,2291,113,71,17912
2021-07-01,19,10446,770,4086,2114,37,70,17523
2021-07-01,20,10464,574,4053,2214,10,69,17384
2021-07-01,21,10475,518,3619,2029,0,29,16670
2021-07-01,22,10457,348,3313,1750,0,18,15886
2021-07-01,23,10465,150,3156,1644,0,18,15433
2021-07-01,24,10470,108,2898,1595,0,18,15089
2021-07-02,1,10462,107,2868,1637,0,18,15092
2021-07-02,2,10460,107,2572,1602,0,18,14759
2021-07-02,3,10456,107,2542,1593,0,18,14716
2021-07-02,4,10450,107,2534,1569,0,18,14678
2021-07-02,5,10459,105,2583,1482,1,19,14649
2021-07-02,6,10475,106,2567,1247,19,25,14439
2021-07-02,7,10485,106,2714,1541,67,32,14945
2021-07-02,8,10491,110,3004,1483,131,34,15253
2021-07-02,9,10495,117,2842,1837,167,34,15492
2021-07-02,10,10498,215,3071,1968,180,33,15965
2021-07-02,11,10498,359,2958,2106,185,32,16138
2021-07-02,12,10501,519,3130,2151,225,32,16558
2021-07-02,13,10498,538,3363,2372,247,32,17050
2021-07-02,14,10488,557,3467,2619,239,33,17403
2021-07-02,15,10501,579,3519,2607,225,33,17464
2021-07-02,16,10491,719,3748,2125,197,53,17333
2021-07-02,17,10489,714,3930,1953,137,84,17307
2021-07-02,18,10482,416,4019,2152,66,86,17221
2021-07-02,19,10459,315,4261,2188,37,84,17344
2021-07-02,20,10439,291,4140,1913,9,84,16876
2021-07-02,21,10426,314,4114,1644,0,83,16581
2021-07-02,22,10420,267,3421,1574,0,78,15760
2021-07-02,23,10420,106,3133,1438,0,18,15115
2021-07-02,24,10420,106,2982,1359,0,2,14869
2021-07-03,1,10433,105,2734,1216,0,0,14488
2021-07-03,2,10441,105,2633,1106,0,0,14285
2021-07-03,3,10447,106,2585,869,0,0,14007
2021-07-03,4,10458,104,2588,809,0,0,13959
2021-07-03,5,10466,106,2583,652,1,0,13808
2021-07-03,6,10469,106,2674,610,15,0,13874
2021-07-03,7,10470,106,2741,312,58,0,13687
2021-07-03,8,10468,114,3226,227,120,0,14155
2021-07-03,9,10466,164,3421,206,240,0,14497
2021-07-03,10,10457,250,3052,295,323,0,14377
2021-07-03,11,10445,399,3396,541,332,0,15113
2021-07-03,12,10435,581,3480,429,358,0,15283
2021-07-03,13,10428,719,3967,281,361,0,15756
2021-07-03,14,10417,738,4087,363,333,0,15938
2021-07-03,15,10407,735,4255,672,341,3,16413
2021-07-03,16,10404,740,3897,918,291,23,16273
2021-07-03,17,10405,763,4263,878,202,54,16565
2021-07-03,18,10406,887,4429,863,107,56,16748
2021-07-03,19,10411,889,4421,662,34,51,16468
2021-07-03,20,10410,904,4058,555,6,51,15984
2021-07-03,21,10404,437,3824,655,0,50,15370
2021-07-03,22,10411,164,3502,671,0,10,14758
2021-07-03,23,10415,111,3221,601,0,0,14348
2021-07-03,24,10425,106,3140,401,0,0,14072
2021-07-04,1,10430,105,3113,371,0,0,14019
2021-07-04,2,10432,105,2635,319,0,0,13491
2021-07-04,3,10432,106,2772,349,0,0,13659
2021-07-04,4,10432,109,2524,320,0,0,13385
2021-07-04,5,10432,106,2501,410,2,0,13451
2021-07-04,6,10419,105,2576,321,7,0,13428
2021-07-04,7,10414,108,2959,238,60,0,13779
2021-07-04,8,10402,133,3449,130,172,0,14286
2021-07-04,9,10406,198,3816,78,271,0,14769
2021-07-04,10,10399,341,3905,40,360,0,15045
2021-07-04,11,10396,572,4196,48,386,5,15603
2021-07-04,12,10390,1165,4045,89,373,4,16066
2021-07-04,13,10386,1035,4167,116,335,1,16040
2021-07-04,14,10383,1135,4232,210,389,0,16349
2021-07-04,15,10383,1384,3729,258,367,6,16127
2021-07-04,16,10379,1467,4065,324,331,36,16602
2021-07-04,17,10364,1457,4672,336,218,54,17101
2021-07-04,18,10362,1535,5035,341,123,57,17453
2021-07-04,19,10361,1145,5001,387,34,87,17015
2021-07-04,20,10364,808,4612,479,9,86,16358
2021-07-04,21,10364,657,4319,692,0,57,16089
2021-07-04,22,10367,437,3548,936,0,54,15342
2021-07-04,23,10360,141,2766,1204,0,55,14526
2021-07-04,24,10360,112,2552,1029,0,54,14107
2021-07-05,1,10364,111,2538,1040,0,64,14117
2021-07-05,2,10360,119,2683,1007,0,61,14230
2021-07-05,3,10348,182,2636,1112,0,54,14332
2021-07-05,4,10345,267,2555,1018,0,54,14239
2021-07-05,5,10345,422,2479,1041,1,54,14342
2021-07-05,6,10343,851,2573,1120,15,54,14956
2021-07-05,7,10340,1031,3150,768,63,78,15430
2021-07-05,8,10336,1341,4146,777,140,81,16821
2021-07-05,9,10335,1978,4241,690,227,80,17551
2021-07-05,10,10329,2276,4119,827,300,81,17932
2021-07-05,11,10326,2691,4064,772,354,83,18290
2021-07-05,12,10319,3002,4376,1006,375,81,19159
2021-07-05,13,10316,3182,4062,1222,369,85,19236
2021-07-05,14,10306,3233,4091,1543,351,87,19611
2021-07-05,15,10302,3404,4098,1721,333,96,19954
2021-07-05,16,10297,3447,4112,2366,277,98,20597
2021-07-05,17,10286,3447,4457,2676,177,95,21138
2021-07-05,18,10283,3359,4647,2516,76,96,20977
2021-07-05,19,10286,2933,4885,2299,32,93,20528
2021-07-05,20,10276,2514,4552,2396,5,93,19836
2021-07-05,21,10279,2269,4178,2554,0,47,19327
2021-07-05,22,10283,2244,3520,2436,0,34,18517
2021-07-05,23,10288,1202,3140,2361,0,24,17015
2021-07-05,24,10291,775,3189,2356,0,19,16630
2021-07-06,1,10288,565,3059,2571,0,17,16500
2021-07-06,2,10289,549,2634,2635,0,17,16124
2021-07-06,3,10290,564,2841,2584,0,18,16297
2021-07-06,4,10298,745,2849,2350,0,19,16261
2021-07-06,5,10302,1121,2736,2001,1,30,16191
2021-07-06,6,10305,2055,3050,1757,6,38,17211
2021-07-06,7,10301,2827,3637,1360,47,69,18241
2021-07-06,8,10305,3423,4132,1007,126,83,19076
2021-07-06,9,10294,3586,4338,808,181,83,19290
2021-07-06,10,10299,3648,4575,791,229,86,19628
2021-07-06,11,10297,4091,4652,803,321,88,20252
2021-07-06,12,10302,4400,4796,770,342,102,20712
2021-07-06,13,10300,4619,4728,1035,352,108,21142
2021-07-06,14,10297,4595,4846,1212,345,134,21429
2021-07-06,15,10300,4705,4838,1217,321,141,21522
2021-07-06,16,10280,4795,5152,1135,291,142,21795
2021-07-06,17,10286,4739,5294,1218,207,138,21882
2021-07-06,18,10297,4699,5518,994,101,133,21742
2021-07-06,19,10307,5154,5254,638,38,144,21535
2021-07-06,20,10310,5325,4952,595,8,156,21346
2021-07-06,21,10315,4603,4784,600,0,101,20403
2021-07-06,22,10319,4384,4331,451,0,39,19524
2021-07-06,23,10326,3216,3838,492,0,16,17888
2021-07-06,24,10338,2666,3199,610,0,11,16824
2021-07-07,1,10349,1933,2717,786,0,10,15795
2021-07-07,2,10349,1426,2861,711,0,10,15357
2021-07-07,3,10339,1367,3210,468,0,10,15394
2021-07-07,4,10337,1546,2719,601,0,11,15214
2021-07-07,5,10336,1826,2603,611,2,15,15393
2021-07-07,6,10332,1967,2629,560,5,21,15514
2021-07-07,7,10320,2010,3386,634,40,27,16417
2021-07-07,8,10323,2169,3981,486,81,27,17067
2021-07-07,9,10327,2754,4398,437,145,27,18088
2021-07-07,10,10324,2732,4122,491,211,27,17907
2021-07-07,11,10318,3017,3813,393,212,26,17779
2021-07-07,12,10315,2867,4028,432,199,45,17886
2021-07-07,13,10319,2923,3969,483,203,73,17970
2021-07-07,14,10325,2968,3993,589,211,78,18164
2021-07-07,15,10311,2801,4051,769,178,78,18188
2021-07-07,16,10311,2737,3935,840,202,76,18101
2021-07-07,17,10310,2509,4087,895,139,75,18015
2021-07-07,18,10306,2289,4300,612,65,77,17649
2021-07-07,19,10301,1963,4449,705,21,76,17515
2021-07-07,20,10304,1763,4679,701,3,80,17530
2021-07-07,21,10308,2001,4068,737,0,81,17195
2021-07-07,22,10311,926,3525,1010,0,79,15851
2021-07-07,23,10312,218,2808,946,0,74,14358
2021-07-07,24,10313,151,2655,823,0,28,13970
2021-07-08,1,10316,151,2568,918,0,11,13964
2021-07-08,2,10324,153,2869,847,0,11,14204
2021-07-08,3,10317,168,2992,778,0,11,14266
2021-07-08,4,10309,258,2970,935,0,11,14483
2021-07-08,5,10308,651,2717,954,0,16,14646
2021-07-08,6,10305,1378,2693,823,4,26,15229
2021-07-08,7,10300,1632,3141,669,14,27,15783
2021-07-08,8,10301,1623,3563,634,39,26,16186
2021-07-08,9,10298,1575,4223,643,82,26,16847
2021-07-08,10,10286,1647,4403,467,100,26,16929
2021-07-08,11,10242,1791,4375,375,124,26,16933
2021-07-08,12,10086,2034,4222,354,147,26,16869
2021-07-08,13,10040,2131,4201,364,150,26,16912
2021-07-08,14,10048,1801,4107,404,61,27,16448
2021-07-08,15,10045,1756,3975,586,61,25,16448
2021-07-08,16,10036,1975,3717,641,110,26,16505
2021-07-08,17,10036,2414,4187,210,61,28,16936
2021-07-08,18,10030,1554,4365,493,57,27,16526
2021-07-08,19,10028,1228,4662,549,23,27,16517
2021-07-08,20,10015,1374,4814,722,4,27,16956
2021-07-08,21,10023,1091,4178,775,0,28,16095
2021-07-08,22,10025,1029,3779,702,0,27,15562
2021-07-08,23,10028,830,3631,653,0,17,15159
2021-07-08,24,10033,385,3242,779,0,12,14451
2021-07-09,1,10050,130,3318,777,0,11,14286
2021-07-09,2,10075,130,3099,837,0,10,14151
2021-07-09,3,10106,221,2891,947,0,11,14176
2021-07-09,4,10137,258,2772,921,0,11,14099
2021-07-09,5,10153,463,2598,966,1,13,14194
2021-07-09,6,10164,810,2585,886,2,23,14470
2021-07-09,7,10163,922,3022,888,27,35,15057
2021-07-09,8,10161,926,3768,935,71,37,15898
2021-07-09,9,10192,927,3945,1089,128,40,16321
2021-07-09,10,10061,1012,4173,1202,212,45,16705
2021-07-09,11,10081,1131,3997,1147,262,42,16660
2021-07-09,12,10137,864,3742,1004,251,31,16029
2021-07-09,13,10282,968,3923,996,225,28,16422
2021-07-09,14,10316,972,4287,965,233,28,16801
2021-07-09,15,10318,893,3966,969,190,28,16364
2021-07-09,16,10322,935,3959,769,174,28,16187
2021-07-09,17,10323,932,4380,840,124,28,16627
2021-07-09,18,10324,926,4425,745,73,27,16520
2021-07-09,19,10329,771,4281,609,25,27,16042
2021-07-09,20,10325,365,4941,453,4,27,16115
2021-07-09,21,10324,379,4640,321,0,27,15691
2021-07-09,22,10328,257,3962,309,0,27,14883
2021-07-09,23,10327,112,3011,282,0,13,13745
2021-07-09,24,10333,109,2700,221,0,2,13365
2021-07-10,1,10330,109,2792,229,0,6,13466
2021-07-10,2,10328,110,2906,251,0,6,13601
2021-07-10,3,10314,110,2775,260,0,0,13459
2021-07-10,4,10311,110,2742,309,0,0,13472
2021-07-10,5,10313,112,2788,282,0,0,13495
2021-07-10,6,10316,113,2904,250,8,0,13591
2021-07-10,7,10314,113,3027,200,44,9,13707
2021-07-10,8,10311,127,3564,65,130,42,14239
2021-07-10,9,10317,316,3797,32,219,86,14767
2021-07-10,10,10309,544,3933,30,308,88,15212
2021-07-10,11,10302,1108,3670,25,323,82,15510
2021-07-10,12,10297,1313,3548,74,360,83,15675
2021-07-10,13,10289,1525,3376,80,345,81,15696
2021-07-10,14,10283,1602,3447,41,316,80,15769
2021-07-10,15,10279,1636,3833,155,301,78,16282
2021-07-10,16,10284,1636,3628,112,322,78,16060
2021-07-10,17,10291,1472,4394,96,234,77,16564
2021-07-10,18,10288,1185,5067,90,119,84,16833
2021-07-10,19,10286,893,5027,107,41,86,16440
2021-07-10,20,10283,769,4818,102,8,79,16059
2021-07-10,21,10284,259,4502,120,0,66,15231
2021-07-10,22,10266,138,4280,196,0,28,14908
2021-07-10,23,10287,131,3558,281,0,13,14270
2021-07-10,24,10301,112,2975,246,0,12,13646
2021-07-11,1,10306,112,2889,304,0,2,13613
2021-07-11,2,10314,112,2836,457,0,0,13719
2021-07-11,3,10314,112,2837,495,0,0,13758
2021-07-11,4,10324,112,2657,470,0,0,13563
2021-07-11,5,10323,112,2587,515,1,0,13538
2021-07-11,6,10333,112,2491,483,8,0,13427
2021-07-11,7,10328,112,2598,711,37,0,13786
2021-07-11,8,10325,114,3268,765,72,0,14544
2021-07-11,9,10330,143,3696,643,115,0,14927
2021-07-11,10,10326,179,3417,700,148,0,14770
2021-07-11,11,10326,230,3313,711,180,0,14760
2021-07-11,12,10324,351,3427,850,204,0,15156
2021-07-11,13,10315,379,3691,980,202,0,15567
2021-07-11,14,10310,437,3654,983,166,0,15550
2021-07-11,15,10314,706,3525,963,147,0,15655
2021-07-11,16,10307,723,3959,935,119,2,16045
2021-07-11,17,10298,729,3862,922,107,1,15919
2021-07-11,18,10299,576,4196,748,81,0,15900
2021-07-11,19,10295,491,4410,960,29,0,16185
2021-07-11,20,10288,493,4470,888,5,0,16144
2021-07-11,21,10297,190,4272,1015,0,0,15774
2021-07-11,22,10296,114,3629,1123,0,0,15162
2021-07-11,23,10299,113,3173,1204,0,0,14789
2021-07-11,24,10304,113,2928,1029,0,0,14374
2021-07-12,1,10304,116,2995,900,0,7,14322
2021-07-12,2,10307,232,3072,773,0,14,14398
2021-07-12,3,10319,334,2826,848,0,14,14341
2021-07-12,4,10320,439,2588,970,0,13,14330
2021-07-12,5,10321,609,2594,1074,1,14,14613
2021-07-12,6,10317,789,2974,906,3,19,15008
2021-07-12,7,10316,1022,3420,873,36,42,15709
2021-07-12,8,10317,1581,4051,635,88,69,16741
2021-07-12,9,10314,2134,4169,616,161,77,17471
2021-07-12,10,10301,1996,4308,627,196,77,17505
2021-07-12,11,10301,2176,4275,683,211,77,17723
2021-07-12,12,10294,2225,4227,671,229,77,17723
2021-07-12,13,10293,2450,4289,630,216,77,17955
2021-07-12,14,10290,2445,4286,587,202,78,17888
2021-07-12,15,10284,2612,4293,510,216,77,17992
2021-07-12,16,10288,2824,4620,383,199,80,18394
2021-07-12,17,10287,3121,5081,466,154,109,19218
2021-07-12,18,10289,3050,4880,510,94,144,18967
2021-07-12,19,10286,2849,4993,458,31,142,18759
2021-07-12,20,10286,2358,5005,456,6,117,18228
2021-07-12,21,10293,2276,4269,626,0,79,17543
2021-07-12,22,10297,2132,3719,633,0,80,16861
2021-07-12,23,10296,1597,3219,626,0,38,15776
2021-07-12,24,10280,502,3040,475,0,13,14310
2021-07-13,1,10281,221,3037,320,0,12,13871
2021-07-13,2,10278,402,3091,318,0,13,14102
2021-07-13,3,10281,633,2871,413,0,13,14211
2021-07-13,4,10279,888,2883,493,0,12,14555
2021-07-13,5,10280,1281,2615,422,2,15,14615
2021-07-13,6,10280,1516,2634,314,6,24,14774
2021-07-13,7,10279,1755,3094,375,31,50,15584
2021-07-13,8,10281,2057,3585,391,59,76,16449
2021-07-13,9,10277,2264,3740,505,119,76,16981
2021-07-13,10,10280,2634,3551,836,211,77,17589
2021-07-13,11,10284,2715,3876,1167,210,78,18330
2021-07-13,12,10282,2893,3731,1657,278,81,18922
2021-07-13,13,10281,2808,3787,1970,250,114,19210
2021-07-13,14,10274,2841,4074,2293,293,109,19884
2021-07-13,15,10276,2910,3945,2435,245,98,19909
2021-07-13,16,10269,3141,4486,2234,164,108,20402
2021-07-13,17,10254,3634,4576,2185,60,133,20842
2021-07-13,18,10259,3128,4493,2228,31,119,20258
2021-07-13,19,10265,3139,4610,1609,28,94,19745
2021-07-13,20,10255,3194,4408,1157,9,118,19141
2021-07-13,21,10241,3291,3982,982,0,82,18578
2021-07-13,22,10224,2745,3228,1089,0,29,17315
2021-07-13,23,10216,1643,2737,1274,0,21,15891
2021-07-13,24,10215,373,3009,1330,0,12,14939
2021-07-14,1,10225,142,3155,1159,0,11,14692
2021-07-14,2,10236,169,2836,1063,0,12,14316
2021-07-14,3,10242,312,2760,1040,0,12,14366
2021-07-14,4,10248,567,2955,1008,0,31,14809
2021-07-14,5,10263,1186,2944,938,1,45,15377
2021-07-14,6,10268,1609,3185,795,1,59,15917
2021-07-14,7,10270,2260,3560,608,13,93,16804
2021-07-14,8,10266,2737,3652,469,49,105,17278
2021-07-14,9,10273,2867,3897,336,113,104,17590
2021-07-14,10,10282,2954,3935,283,176,109,17739
2021-07-14,11,10291,3639,3815,355,265,108,18473
2021-07-14,12,10295,3865,3872,557,271,107,18967
2021-07-14,13,10272,4008,3937,802,337,110,19466
2021-07-14,14,10249,4375,3862,901,356,111,19854
2021-07-14,15,10257,4478,3960,818,368,115,19996
2021-07-14,16,10261,4621,4547,781,298,113,20621
2021-07-14,17,10253,5015,4656,873,222,156,21175
2021-07-14,18,10234,4806,4737,636,120,154,20687
2021-07-14,19,10229,4910,4777,533,39,207,20695
2021-07-14,20,10230,4511,4534,652,7,134,20068
2021-07-14,21,10228,3915,4192,824,0,98,19257
2021-07-14,22,10237,3191,3765,917,0,49,18159
2021-07-14,23,10243,2785,3174,1074,0,19,17295
2021-07-14,24,10251,952,2870,1210,0,14,15297
2021-07-15,1,10252,418,2633,1341,0,12,14656
2021-07-15,2,10252,447,2508,1467,0,11,14685
2021-07-15,3,10263,735,2519,1445,0,11,14973
2021-07-15,4,10274,819,2703,1554,0,11,15361
2021-07-15,5,10269,1061,2661,1657,1,19,15668
2021-07-15,6,10278,1390,2596,1580,6,31,15881
2021-07-15,7,10269,1696,2806,1846,49,47,16713
2021-07-15,8,10264,2088,3061,2191,133,79,17816
2021-07-15,9,10263,2259,3200,2408,223,99,18452
2021-07-15,10,10256,2680,3096,2675,296,100,19103
2021-07-15,11,10245,3179,3574,2521,318,103,19940
2021-07-15,12,10221,3193,3765,2764,333,102,20378
2021-07-15,13,10210,3197,3824,2746,339,93,20409
2021-07-15,14,10211,3232,4162,2653,295,94,20647
2021-07-15,15,10203,3404,4518,2431,256,93,20905
2021-07-15,16,10196,4194,4652,2106,208,93,21449
2021-07-15,17,10195,4489,4555,2188,132,98,21657
2021-07-15,18,10220,4002,4733,1939,70,90,21054
2021-07-15,19,10214,3665,4821,1821,35,87,20643
2021-07-15,20,10216,3481,4500,2012,6,80,20295
2021-07-15,21,10234,3533,4469,1732,0,80,20048
2021-07-15,22,10231,2859,4344,1254,0,41,18729
2021-07-15,23,10276,2256,4006,669,0,18,17225
2021-07-15,24,10293,1373,3769,451,0,12,15898
2021-07-16,1,10314,726,3271,390,0,11,14712
2021-07-16,2,10326,327,3350,323,0,11,14337
2021-07-16,3,10336,317,3350,290,0,11,14304
2021-07-16,4,10338,515,3345,218,0,11,14427
2021-07-16,5,10346,969,3084,176,1,20,14596
2021-07-16,6,10348,1408,3216,231,3,28,15234
2021-07-16,7,10345,1973,3329,213,32,58,15950
2021-07-16,8,10340,2148,3796,279,101,80,16744
2021-07-16,9,10341,2245,3979,249,162,82,17058
2021-07-16,10,10337,2753,4024,261,187,83,17645
2021-07-16,11,10338,2856,4306,348,215,83,18146
2021-07-16,12,10327,2598,4473,522,214,78,18212
2021-07-16,13,10314,2646,4631,617,215,79,18502
2021-07-16,14,10320,2935,4759,590,214,82,18900
2021-07-16,15,10323,3187,4796,463,171,82,19022
2021-07-16,16,10319,3435,4848,383,120,83,19188
2021-07-16,17,10308,3254,5022,393,83,85,19145
2021-07-16,18,10300,2766,5050,346,51,85,18598
2021-07-16,19,10309,2656,4726,399,24,82,18196
2021-07-16,20,10316,2222,5177,423,3,79,18220
2021-07-16,21,10333,1894,4639,542,0,80,17488
2021-07-16,22,10343,1135,4224,817,0,81,16600
2021-07-16,23,10348,675,3361,714,0,72,15170
2021-07-16,24,10349,256,3352,553,0,30,14540
2021-07-17,1,10352,161,3363,545,0,7,14428
2021-07-17,2,10345,155,3464,687,0,0,14651
2021-07-17,3,10335,123,3204,828,0,1,14491
2021-07-17,4,10329,123,3238,841,0,4,14535
2021-07-17,5,10323,124,3050,1036,0,19,14552
2021-07-17,6,10316,124,3082,960,3,51,14536
2021-07-17,7,10315,126,3205,892,14,53,14605
2021-07-17,8,10304,143,3412,983,39,77,14958
2021-07-17,9,10301,308,4037,1042,62,56,15806
2021-07-17,10,10318,447,4182,952,99,55,16053
2021-07-17,11,10312,624,3984,1105,162,16,16203
2021-07-17,12,10293,626,3939,1271,184,0,16313
2021-07-17,13,10299,587,3791,1240,183,0,16100
2021-07-17,14,10296,613,3850,1337,209,0,16305
2021-07-17,15,10295,703,4015,1420,204,0,16637
2021-07-17,16,10292,709,4527,1288,163,0,16979
2021-07-17,17,10293,572,4753,1133,127,0,16878
2021-07-17,18,10290,502,5022,914,67,0,16795
2021-07-17,19,10288,592,5147,599,31,0,16657
2021-07-17,20,10284,748,5089,537,5,0,16663
2021-07-17,21,10288,301,4738,615,0,4,15946
2021-07-17,22,10236,199,4162,656,0,3,15256
2021-07-17,23,10229,131,3605,665,0,1,14631
2021-07-17,24,10226,129,3283,677,0,1,14316
2021-07-18,1,10229,130,3208,599,0,0,14166
2021-07-18,2,10259,129,3027,618,0,0,14033
2021-07-18,3,10271,131,2968,437,0,0,13807
2021-07-18,4,10260,130,2931,393,0,0,13714
2021-07-18,5,10249,170,3056,512,1,0,13988
2021-07-18,6,10246,216,3070,373,9,0,13914
2021-07-18,7,10242,346,3043,186,12,0,13829
2021-07-18,8,10238,518,3213,244,79,2,14294
2021-07-18,9,10225,1021,3386,226,206,8,15072
2021-07-18,10,10229,1341,3894,375,297,35,16171
2021-07-18,11,10228,1673,3864,377,343,56,16541
2021-07-18,12,10236,2206,4217,493,362,56,17570
2021-07-18,13,10238,2293,4218,608,350,56,17763
2021-07-18,14,10216,2496,4457,631,339,54,18193
2021-07-18,15,10147,2485,4643,628,316,13,18232
2021-07-18,16,10165,2624,4716,579,273,0,18357
2021-07-18,17,10201,3243,4990,474,153,0,19061
2021-07-18,18,10237,2902,5183,335,88,0,18745
2021-07-18,19,10255,2615,5139,284,37,0,18330
2021-07-18,20,10249,2714,4986,255,5,0,18209
2021-07-18,21,10233,2230,4958,245,0,0,17666
2021-07-18,22,10225,1896,4244,277,0,2,16644
2021-07-18,23,10227,1030,3706,281,0,30,15274
2021-07-18,24,10219,932,3397,207,0,56,14811
2021-07-19,1,10236,617,3528,341,0,77,14799
2021-07-19,2,10264,553,3211,301,0,53,14382
2021-07-19,3,10290,584,3155,350,0,61,14440
2021-07-19,4,10297,764,3052,283,0,62,14458
2021-07-19,5,10306,1204,3105,239,1,66,14921
2021-07-19,6,10310,1495,3255,200,6,79,15345
2021-07-19,7,10293,1976,3471,191,49,80,16060
2021-07-19,8,10256,2033,3892,178,120,80,16559
2021-07-19,9,10243,2206,4140,138,202,99,17028
2021-07-19,10,10247,2568,4533,98,293,105,17844
2021-07-19,11,10244,3079,4600,131,339,104,18497
2021-07-19,12,10231,3762,4711,134,354,107,19299
2021-07-19,13,10219,4265,4733,149,327,107,19800
2021-07-19,14,10201,4821,4692,195,304,104,20317
2021-07-19,15,10201,4948,4822,228,293,96,20588
2021-07-19,16,10198,4696,4956,308,238,97,20493
2021-07-19,17,10208,4188,5106,341,157,95,20095
2021-07-19,18,10243,4053,5178,378,84,94,20030
2021-07-19,19,10288,4222,5072,317,33,95,20027
2021-07-19,20,10303,4385,5004,296,4,90,20082
2021-07-19,21,10316,4219,4798,345,0,86,19764
2021-07-19,22,10323,3883,4213,353,0,105,18877
2021-07-19,23,10354,2608,3713,260,0,141,17076
2021-07-19,24,10341,1694,3490,221,0,191,15937
2021-07-20,1,10326,1525,3456,198,0,170,15675
2021-07-20,2,10315,1420,3138,228,0,77,15178
2021-07-20,3,10301,1430,2991,305,0,14,15041
2021-07-20,4,10285,1592,2997,365,0,14,15253
2021-07-20,5,10281,1798,2846,275,1,14,15215
2021-07-20,6,10269,1997,3011,310,5,23,15615
2021-07-20,7,10265,2064,3313,370,50,28,16090
2021-07-20,8,10258,2417,3804,200,129,28,16836
2021-07-20,9,10266,2965,4144,244,213,28,17860
2021-07-20,10,10278,3730,4217,317,303,27,18872
2021-07-20,11,10281,3659,4422,510,359,27,19258
2021-07-20,12,10286,3939,4622,827,370,37,20081
2021-07-20,13,10306,4167,4618,1059,368,71,20589
2021-07-20,14,10317,4129,4813,1189,347,80,20875
2021-07-20,15,10310,4371,4909,1233,267,80,21170
2021-07-20,16,10311,4251,5146,1202,153,83,21146
2021-07-20,17,10318,4176,5051,1196,90,93,20924
2021-07-20,18,10350,3663,4962,893,66,92,20026
2021-07-20,19,10371,3271,4467,1163,22,81,19375
2021-07-20,20,10388,2905,4185,1214,4,81,18777
2021-07-20,21,10400,2239,3767,1403,0,80,17889
2021-07-20,22,10417,1249,3215,1471,0,37,16389
2021-07-20,23,10427,1042,3227,1260,0,17,15973
2021-07-20,24,10418,698,3185,658,0,12,14971
2021-07-21,1,10403,266,2956,1104,0,12,14741
2021-07-21,2,10387,180,3008,989,0,12,14576
2021-07-21,3,10377,182,2963,1045,0,12,14579
2021-07-21,4,10378,190,2993,1060,0,12,14633
2021-07-21,5,10366,322,2881,1084,1,14,14668
2021-07-21,6,10369,617,2857,759,6,22,14630
2021-07-21,7,10390,901,3190,596,40,27,15144
2021-07-21,8,10410,1147,3516,917,134,27,16151
2021-07-21,9,10422,1333,3492,1009,275,27,16558
2021-07-21,10,10423,1470,3657,1053,371,28,17002
2021-07-21,11,10402,1683,3761,1088,398,26,17358
2021-07-21,12,10384,1832,3884,1112,386,27,17625
2021-07-21,13,10370,2119,3964,1186,372,27,18038
2021-07-21,14,10356,2336,4055,1058,346,27,18178
2021-07-21,15,10350,2317,3982,965,350,27,17991
2021-07-21,16,10344,2035,4063,1098,290,27,17857
2021-07-21,17,10338,1797,4233,1351,220,26,17965
2021-07-21,18,10339,1785,4501,1192,127,27,17971
2021-07-21,19,10335,1812,4536,907,42,27,17659
2021-07-21,20,10332,1693,4425,838,9,30,17327
2021-07-21,21,10341,1501,4335,875,0,28,17080
2021-07-21,22,10370,665,4013,874,0,27,15949
2021-07-21,23,10406,523,3297,691,0,15,14932
2021-07-21,24,10434,216,3087,451,0,11,14199
2021-07-22,1,10449,135,3112,415,0,10,14121
2021-07-22,2,10450,128,3066,484,0,10,14138
2021-07-22,3,10457,129,3082,378,0,10,14056
2021-07-22,4,10448,137,3116,345,0,11,14057
2021-07-22,5,10445,289,3169,356,2,8,14269
2021-07-22,6,10438,531,3237,357,11,7,14581
2021-07-22,7,10420,817,3844,294,55,24,15454
2021-07-22,8,10404,1006,3975,130,128,26,15669
2021-07-22,9,10384,1119,3937,35,225,26,15726
2021-07-22,10,10361,1231,3950,53,300,26,15921
2021-07-22,11,10351,1302,3977,100,367,26,16123
2021-07-22,12,10353,1968,4081,133,335,26,16896
2021-07-22,13,10346,2139,3959,193,328,26,16991
2021-07-22,14,10325,2276,4056,272,250,26,17205
2021-07-22,15,10317,2398,4149,324,219,26,17433
2021-07-22,16,10337,2626,4335,356,218,26,17898
2021-07-22,17,10362,2799,4736,387,174,26,18484
2021-07-22,18,10386,2711,4670,348,111,27,18253
2021-07-22,19,10401,2434,4535,320,39,27,17756
2021-07-22,20,10416,2282,4298,296,8,27,17327
2021-07-22,21,10430,1751,4378,204,0,27,16790
2021-07-22,22,10434,958,4188,165,0,27,15772
2021-07-22,23,10444,550,3419,208,0,15,14636
2021-07-22,24,10452,177,3375,182,0,10,14196
2021-07-23,1,10453,106,3254,192,0,10,14015
2021-07-23,2,10454,106,3394,174,0,10,14138
2021-07-23,3,10446,106,3395,166,0,10,14123
2021-07-23,4,10433,107,3427,161,0,11,14139
2021-07-23,5,10399,135,3564,202,1,15,14316
2021-07-23,6,10385,192,3554,243,4,22,14400
2021-07-23,7,10388,554,3878,287,45,31,15183
2021-07-23,8,10406,900,3827,262,142,33,15570
2021-07-23,9,10412,1223,4175,201,255,38,16304
2021-07-23,10,10398,1288,4104,224,337,43,16394
2021-07-23,11,10368,1509,4223,291,362,42,16795
2021-07-23,12,10350,1597,4576,349,350,39,17261
2021-07-23,13,10333,1865,4536,355,328,28,17445
2021-07-23,14,10323,2076,4698,408,340,28,17873
2021-07-23,15,10325,2082,4439,409,346,28,17629
2021-07-23,16,10372,2287,4770,337,305,27,18098
2021-07-23,17,10388,2739,5050,314,221,27,18739
2021-07-23,18,10398,2665,5213,292,116,27,18711
2021-07-23,19,10405,2664,5060,270,34,27,18460
2021-07-23,20,10417,2264,4677,394,7,27,17786
2021-07-23,21,10407,1874,4479,526,0,27,17313
2021-07-23,22,10392,1182,4193,619,0,26,16412
2021-07-23,23,10404,268,3672,775,0,19,15138
2021-07-23,24,10397,116,3211,936,0,13,14673
2021-07-24,1,10385,117,2995,913,0,5,14415
2021-07-24,2,10367,118,3033,949,0,0,14467
2021-07-24,3,10351,116,3032,1077,0,0,14576
2021-07-24,4,10337,117,3076,1267,0,0,14797
2021-07-24,5,10340,116,2897,1172,1,0,14526
2021-07-24,6,10364,116,2914,1157,5,0,14556
2021-07-24,7,10379,125,3082,1045,37,1,14669
2021-07-24,8,10381,135,3059,1362,115,1,15053
2021-07-24,9,10387,221,3260,1534,186,1,15589
2021-07-24,10,10383,378,3229,1532,228,0,15750
2021-07-24,11,10373,641,3958,1617,228,1,16818
2021-07-24,12,10359,564,3836,1888,237,0,16884
2021-07-24,13,10332,569,3613,2073,227,0,16814
2021-07-24,14,10313,577,4045,2411,177,0,17523
2021-07-24,15,10303,542,3815,2601,129,0,17390
2021-07-24,16,10274,541,3849,2961,153,0,17778
2021-07-24,17,10262,540,3901,3020,91,0,17814
2021-07-24,18,10253,200,4232,3290,39,0,18014
2021-07-24,19,10248,114,4563,3088,16,0,18029
2021-07-24,20,10258,131,4013,3177,0,0,17579
2021-07-24,21,10285,287,4417,2761,0,0,17750
2021-07-24,22,10297,230,4468,2437,0,2,17434
2021-07-24,23,10307,191,4151,2021,0,1,16671
2021-07-24,24,10287,120,3471,1665,0,0,15543
2021-07-25,1,10233,118,3270,1482,0,1,15104
2021-07-25,2,10220,118,3208,1322,0,1,14869
2021-07-25,3,10229,116,3010,1042,0,0,14397
2021-07-25,4,10222,132,3017,760,0,0,14131
2021-07-25,5,10224,148,3346,571,2,0,14291
2021-07-25,6,10261,209,3313,376,4,0,14163
2021-07-25,7,10290,256,3462,314,39,0,14361
2021-07-25,8,10305,544,3748,226,126,0,14949
2021-07-25,9,10318,999,4230,172,211,0,15930
2021-07-25,10,10338,1481,4357,186,286,0,16648
2021-07-25,11,10357,1831,4173,314,303,0,16978
2021-07-25,12,10370,2254,4210,624,334,0,17792
2021-07-25,13,10370,2440,3988,912,352,4,18066
2021-07-25,14,10316,2661,3880,869,352,5,18083
2021-07-25,15,10361,2818,3894,702,311,17,18103
2021-07-25,16,10357,2857,4572,875,272,49,18982
2021-07-25,17,10345,3115,5147,689,185,56,19537
2021-07-25,18,10339,3275,5390,504,95,56,19659
2021-07-25,19,10344,3584,5048,416,27,57,19476
2021-07-25,20,10349,3204,4816,380,4,57,18810
2021-07-25,21,10357,3031,4767,303,0,81,18539
2021-07-25,22,10380,2344,4226,358,0,53,17361
2021-07-25,23,10399,1645,3925,428,0,12,16409
2021-07-25,24,10426,1258,3639,330,0,0,15653
2021-07-26,1,10451,572,3407,389,0,0,14819
2021-07-26,2,10463,589,3340,610,0,9,15011
2021-07-26,3,10470,845,3353,351,0,12,15031
2021-07-26,4,10468,943,3323,293,0,12,15039
2021-07-26,5,10459,1149,3296,119,0,14,15037
2021-07-26,6,10452,1503,3346,115,2,26,15444
2021-07-26,7,10438,2033,3668,266,38,56,16499
2021-07-26,8,10415,2231,3886,319,111,80,17042
2021-07-26,9,10409,2470,4091,135,211,83,17399
2021-07-26,10,10400,2709,3830,128,300,82,17449
2021-07-26,11,10378,2947,4378,196,360,82,18341
2021-07-26,12,10365,3339,4567,285,373,83,19012
2021-07-26,13,10365,3495,4696,386,322,83,19347
2021-07-26,14,10360,3708,4674,495,305,84,19626
2021-07-26,15,10371,3819,4844,463,264,88,19849
2021-07-26,16,10373,4037,4998,456,245,91,20200
2021-07-26,17,10377,4385,5090,434,190,95,20571
2021-07-26,18,10381,4209,5116,358,104,108,20276
2021-07-26,19,10377,4380,5066,258,31,122,20234
2021-07-26,20,10392,4144,5012,243,6,123,19920
2021-07-26,21,10420,3893,5084,238,0,107,19742
2021-07-26,22,10430,2899,4673,202,0,87,18291
2021-07-26,23,10455,1516,4203,259,0,75,16508
2021-07-26,24,10469,863,3889,372,0,107,15700
2021-07-27,1,10471,315,3524,477,0,47,14834
2021-07-27,2,10459,194,3521,570,0,16,14760
2021-07-27,3,10453,273,3620,610,0,16,14972
2021-07-27,4,10425,447,3604,450,0,17,14943
2021-07-27,5,10403,591,3553,458,3,21,15029
2021-07-27,6,10381,602,3543,510,5,31,15072
2021-07-27,7,10370,645,3550,823,29,46,15463
2021-07-27,8,10348,1046,3841,750,103,81,16169
2021-07-27,9,10332,1486,4363,461,127,84,16853
2021-07-27,10,10329,1795,4383,221,193,83,17004
2021-07-27,11,10364,1959,4535,282,121,83,17344
2021-07-27,12,10408,2176,4086,128,68,86,16952
2021-07-27,13,10414,2580,4121,232,155,114,17616
2021-07-27,14,10428,2839,4205,432,162,120,18186
2021-07-27,15,10440,2818,4255,381,146,89,18129
2021-07-27,16,10436,2688,4778,351,166,85,18504
2021-07-27,17,10434,2837,5170,319,184,86,19030
2021-07-27,18,10418,3053,5171,247,114,86,19089
2021-07-27,19,10397,2562,4958,178,34,86,18215
2021-07-27,20,10391,2515,4833,175,5,86,18005
2021-07-27,21,10384,1787,4932,146,0,85,17334
2021-07-27,22,10382,1493,4685,132,0,104,16796
2021-07-27,23,10365,700,4354,152,0,98,15669
2021-07-27,24,10348,222,4084,199,0,99,14952
2021-07-28,1,10329,203,3811,287,0,73,14703
2021-07-28,2,10315,191,3681,383,0,71,14641
2021-07-28,3,10363,278,3349,437,0,28,14455
2021-07-28,4,10411,545,3279,307,0,17,14559
2021-07-28,5,10440,622,3415,482,1,20,14980
2021-07-28,6,10451,859,3523,516,6,29,15384
2021-07-28,7,10455,1234,3583,408,51,32,15763
2021-07-28,8,10458,1490,3988,213,152,32,16333
2021-07-28,9,10458,1844,4193,89,266,32,16882
2021-07-28,10,10441,2008,4401,53,349,32,17284
2021-07-28,11,10409,2161,4940,67,370,32,17979
2021-07-28,12,10349,2315,4887,91,357,32,18031
2021-07-28,13,10313,2351,4761,137,351,44,17957
2021-07-28,14,10320,2445,4823,164,330,71,18153
2021-07-28,15,10290,2650,4969,155,256,82,18402
2021-07-28,16,10270,2760,5106,210,256,82,18684
2021-07-28,17,10282,2941,5267,262,207,83,19042
2021-07-28,18,10342,2739,5244,218,104,83,18730
2021-07-28,19,10378,2693,5075,226,31,83,18486
2021-07-28,20,10399,2321,4794,315,6,84,17919
2021-07-28,21,10416,1871,4554,506,0,83,17430
2021-07-28,22,10412,1468,4219,744,0,88,16931
2021-07-28,23,10407,717,3655,563,0,153,15495
2021-07-28,24,10388,233,3517,681,0,119,14938
2021-07-29,1,10377,262,3423,810,0,69,14941
2021-07-29,2,10368,251,3420,1016,0,68,15123
2021-07-29,3,10352,281,3204,901,0,67,14805
2021-07-29,4,10346,545,3415,594,0,67,14967
2021-07-29,5,10328,548,3395,1005,0,70,15346
2021-07-29,6,10315,548,3579,1313,2,78,15835
2021-07-29,7,10284,556,3866,1551,9,82,16348
2021-07-29,8,10272,565,4109,1527,22,82,16577
2021-07-29,9,10277,941,4677,1289,43,44,17271
2021-07-29,10,10280,1465,4699,974,128,31,17577
2021-07-29,11,10268,1549,4364,936,272,31,17420
2021-07-29,12,10260,1840,4303,1214,236,47,17900
2021-07-29,13,10260,1964,4453,1240,230,48,18195
2021-07-29,14,10275,1894,4383,1459,267,54,18332
2021-07-29,15,10286,1885,4497,1523,256,65,18512
2021-07-29,16,10301,1860,4630,1485,240,58,18574
2021-07-29,17,10301,1888,4952,1397,176,50,18764
2021-07-29,18,10288,1865,4961,1411,94,59,18678
2021-07-29,19,10287,1887,5117,1124,32,60,18507
2021-07-29,20,10287,1634,4704,1488,3,53,18169
2021-07-29,21,10290,1039,4593,1320,0,52,17294
2021-07-29,22,10269,631,4416,1404,0,55,16775
2021-07-29,23,10244,212,4018,1490,0,48,16012
2021-07-29,24,10228,178,3372,1739,0,35,15552
2021-07-30,1,10240,115,3079,1761,0,42,15237
2021-07-30,2,10267,114,3043,1650,0,43,15117
2021-07-30,3,10306,114,2982,1429,0,47,14878
2021-07-30,4,10344,113,3099,1198,0,46,14800
2021-07-30,5,10361,113,3163,1138,2,40,14817
2021-07-30,6,10380,113,3336,1365,5,37,15236
2021-07-30,7,10391,136,3852,1134,44,40,15597
2021-07-30,8,10405,245,4309,1053,142,34,16188
2021-07-30,9,10413,164,3754,1114,254,31,15730
2021-07-30,10,10425,170,3888,1152,316,38,15989
2021-07-30,11,10423,245,3956,1485,351,42,16502
2021-07-30,12,10417,275,3768,1542,365,48,16415
2021-07-30,13,10409,383,3847,1530,357,50,16576
2021-07-30,14,10394,541,4156,1461,363,43,16958
2021-07-30,15,10382,558,4120,1542,346,36,16984
2021-07-30,16,10353,564,4093,1427,309,32,16778
2021-07-30,17,10338,602,4498,1272,230,34,16974
2021-07-30,18,10338,736,4802,962,119,31,16988
2021-07-30,19,10338,863,4872,685,34,31,16823
2021-07-30,20,10348,418,4568,490,6,30,15860
2021-07-30,21,10378,314,4619,359,0,31,15701
2021-07-30,22,10412,373,4179,297,0,31,15292
2021-07-30,23,10422,310,3768,245,0,15,14760
2021-07-30,24,10425,199,3598,219,0,4,14445
2021-07-31,1,10450,125,3157,198,0,0,13930
2021-07-31,2,10411,124,3293,201,0,0,14029
2021-07-31,3,10195,125,3436,184,0,0,13940
2021-07-31,4,10203,169,3552,179,0,0,14103
2021-07-31,5,10202,127,3212,198,1,0,13740
2021-07-31,6,10195,126,3066,286,6,0,13679
2021-07-31,7,10188,126,3075,369,50,0,13808
2021-07-31,8,10159,127,3162,244,153,0,13845
2021-07-31,9,10110,132,3727,201,273,0,14443
2021-07-31,10,10296,218,3927,197,364,0,15002
2021-07-31,11,10355,292,3947,391,371,0,15356
2021-07-31,12,10353,308,3923,709,348,0,15641
2021-07-31,13,10363,241,3899,895,328,0,15726
2021-07-31,14,10379,251,3933,856,289,0,15708
2021-07-31,15,10371,288,3855,1077,265,0,15856
2021-07-31,16,10359,349,4036,964,200,0,15908
2021-07-31,17,10355,353,4014,1342,136,0,16200
2021-07-31,18,10350,357,4014,1085,86,2,15894
2021-07-31,19,10351,356,4152,849,27,1,15736
2021-07-31,20,10363,357,4484,743,5,0,15952
2021-07-31,21,10376,350,4493,710,0,0,15929
2021-07-31,22,10388,247,3988,757,0,0,15380
2021-07-31,23,10386,168,3698,680,0,1,14933
2021-07-31,24,10348,132,3412,575,0,3,14470
2021-08-01,1,10301,125,3338,509,0,28,14301
2021-08-01,2,10286,124,3235,553,0,35,14233
2021-08-01,3,10286,124,3192,518,0,36,14156
2021-08-01,4,10299,123,3195,418,0,38,14073
2021-08-01,5,10321,122,3013,270,1,41,13768
2021-08-01,6,10340,121,2970,234,2,40,13707
2021-08-01,7,10354,124,3006,295,27,33,13839
2021-08-01,8,10345,125,3226,357,71,29,14153
2021-08-01,9,10339,127,3514,458,113,34,14585
2021-08-01,10,10329,148,4084,599,155,33,15348
2021-08-01,11,10320,132,3940,562,170,35,15159
2021-08-01,12,10344,125,3646,714,185,35,15049
2021-08-01,13,10363,125,3682,964,235,39,15408
2021-08-01,14,10388,121,3824,1332,248,43,15956
2021-08-01,15,10387,120,3683,1515,269,43,16017
2021-08-01,16,10372,120,3778,1801,185,42,16298
2021-08-01,17,10361,120,3930,1465,124,40,16040
2021-08-01,18,10351,119,3731,1546,115,42,15904
2021-08-01,19,10348,119,4069,1521,32,37,16126
2021-08-01,20,10351,119,4223,1401,6,37,16137
2021-08-01,21,10363,119,4240,1408,0,33,16163
2021-08-01,22,10360,120,3834,1453,0,37,15804
2021-08-01,23,10354,120,3215,1260,0,38,14987
2021-08-01,24,10348,120,3108,901,0,38,14515
2021-08-02,1,10347,120,3057,871,0,40,14435
2021-08-02,2,10364,120,2867,535,0,41,13927
2021-08-02,3,10393,120,2852,432,0,40,13837
2021-08-02,4,10173,119,2889,481,0,39,13701
2021-08-02,5,10113,120,2789,600,2,37,13661
2021-08-02,6,10128,119,2671,445,4,41,13408
2021-08-02,7,10139,120,3050,490,45,38,13882
2021-08-02,8,10363,118,3249,252,161,23,14166
2021-08-02,9,10428,116,3132,181,284,33,14174
2021-08-02,10,10406,116,3353,202,375,37,14489
2021-08-02,11,10390,182,3622,232,400,33,14859
2021-08-02,12,10369,188,3766,315,387,35,15060
2021-08-02,13,10353,278,3822,383,383,33,15252
2021-08-02,14,10346,416,3742,394,379,33,15310
2021-08-02,15,10336,542,4106,352,355,34,15725
2021-08-02,16,10325,615,4487,352,275,34,16088
2021-08-02,17,10306,820,4929,339,211,33,16638
2021-08-02,18,10299,916,4828,346,111,31,16531
2021-08-02,19,10304,891,4887,412,29,28,16551
2021-08-02,20,10312,838,4496,500,2,26,16174
2021-08-02,21,10319,447,4250,539,0,22,15577
2021-08-02,22,10338,376,3770,619,0,28,15131
2021-08-02,23,10364,372,3396,671,0,27,14830
2021-08-02,24,10380,353,2963,639,0,27,14362
2021-08-03,1,10405,264,2719,440,0,28,13856
2021-08-03,2,10405,178,2770,474,0,39,13866
2021-08-03,3,10397,260,2754,425,0,43,13879
2021-08-03,4,10203,283,2790,515,0,48,13839
2021-08-03,5,10044,403,3015,639,1,48,14150
2021-08-03,6,10030,613,3030,485,3,54,14215
2021-08-03,7,10035,831,3749,435,42,63,15155
2021-08-03,8,10281,990,3981,249,134,75,15710
2021-08-03,9,10284,1180,4271,170,257,73,16235
2021-08-03,10,10274,1244,4114,279,322,66,16299
2021-08-03,11,10268,1454,4043,338,337,69,16509
2021-08-03,12,10282,1844,3867,401,334,69,16797
2021-08-03,13,10322,2119,3491,467,333,69,16801
2021-08-03,14,10339,2221,3611,424,378,71,17044
2021-08-03,15,10364,2374,4003,198,258,70,17267
2021-08-03,16,10370,2527,4353,466,302,68,18086
2021-08-03,17,10362,2775,5013,332,210,72,18764
2021-08-03,18,10337,2538,5226,256,116,68,18541
2021-08-03,19,10325,2379,5212,209,33,70,18228
2021-08-03,20,10297,2330,4628,228,4,67,17554
2021-08-03,21,10283,2209,4396,241,0,68,17197
2021-08-03,22,10276,1408,3946,239,0,71,15940
2021-08-03,23,10254,637,3719,301,0,64,14975
2021-08-03,24,10241,372,3528,304,0,56,14501
2021-08-04,1,10234,143,3241,281,0,58,13957
2021-08-04,2,10246,117,3142,250,0,57,13812
2021-08-04,3,10260,128,3301,180,0,54,13923
2021-08-04,4,10296,255,3277,183,0,55,14066
2021-08-04,5,10311,462,3412,138,1,60,14384
2021-08-04,6,10333,821,3440,120,5,68,14787
2021-08-04,7,10338,1275,3706,78,45,61,15503
2021-08-04,8,10331,1650,3686,64,144,59,15934
2021-08-04,9,10310,1822,3629,39,266,50,16116
2021-08-04,10,10283,1999,3591,28,357,47,16305
2021-08-04,11,10281,2575,3438,34,402,56,16786
2021-08-04,12,10275,2898,3567,45,411,54,17250
2021-08-04,13,10258,3236,3711,78,381,50,17714
2021-08-04,14,10230,3679,3820,118,393,48,18288
2021-08-04,15,10203,3707,4063,138,385,51,18547
2021-08-04,16,10189,4074,4473,150,327,50,19263
2021-08-04,17,10187,4213,5226,131,218,52,20027
2021-08-04,18,10195,4193,5285,100,112,41,19926
2021-08-04,19,10215,3869,5039,112,33,39,19307
2021-08-04,20,10231,3492,4811,162,5,33,18734
2021-08-04,21,10243,2872,4757,167,0,32,18071
2021-08-04,22,10262,2051,4210,233,0,35,16791
2021-08-04,23,10280,1175,3628,266,0,27,15376
2021-08-04,24,10289,541,3301,299,0,21,14451
2021-08-05,1,10301,172,3371,294,0,27,14165
2021-08-05,2,10309,199,3201,297,0,30,14036
2021-08-05,3,10308,350,3363,288,0,31,14340
2021-08-05,4,10294,476,3272,304,0,36,14382
2021-08-05,5,10286,665,3404,279,0,41,14675
2021-08-05,6,10274,1114,3426,292,5,49,15160
2021-08-05,7,10256,1579,3290,250,40,46,15461
2021-08-05,8,10236,1999,3430,171,110,42,15988
2021-08-05,9,10215,2428,3752,102,235,34,16766
2021-08-05,10,10203,3214,3786,71,329,32,17635
2021-08-05,11,10199,3622,3713,72,389,32,18027
2021-08-05,12,10193,3827,3910,155,399,33,18517
2021-08-05,13,10188,4050,3899,242,414,32,18825
2021-08-05,14,10205,4150,4090,335,406,36,19222
2021-08-05,15,10238,4439,4333,328,361,51,19750
2021-08-05,16,10240,4865,4415,287,285,79,20171
2021-08-05,17,10243,5090,5074,279,205,96,20987
2021-08-05,18,10244,5013,5046,332,102,88,20825
2021-08-05,19,10238,4666,4962,460,30,84,20440
2021-08-05,20,10232,3920,4852,687,5,83,19779
2021-08-05,21,10215,3512,4604,824,0,109,19264
2021-08-05,22,10217,2420,4102,1051,0,120,17910
2021-08-05,23,10211,1437,3428,1194,0,121,16391
2021-08-05,24,10218,666,3167,1138,0,99,15288
2021-08-06,1,10217,206,3123,1286,0,49,14881
2021-08-06,2,10230,222,3200,1258,0,17,14927
2021-08-06,3,10232,450,2861,1199,0,17,14759
2021-08-06,4,10225,580,2780,1157,0,17,14759
2021-08-06,5,10222,823,2855,927,2,18,14847
2021-08-06,6,10215,1062,2861,1277,4,25,15444
2021-08-06,7,10228,1429,2952,1096,40,39,15784
2021-08-06,8,10243,1893,3472,1011,127,74,16820
2021-08-06,9,10252,2244,3774,796,238,111,17415
2021-08-06,10,10269,2693,3613,840,314,127,17856
2021-08-06,11,10249,3214,3559,1052,348,95,18517
2021-08-06,12,10240,3107,3926,1277,362,91,19003
2021-08-06,13,10244,3344,3892,1571,353,90,19494
2021-08-06,14,10239,3422,3863,1760,343,86,19713
2021-08-06,15,10233,3458,3842,1929,329,85,19876
2021-08-06,16,10216,3454,4305,1651,276,84,19986
2021-08-06,17,10202,3740,4825,1362,177,84,20390
2021-08-06,18,10208,3805,5172,1176,90,83,20534
2021-08-06,19,10209,3940,4814,942,27,86,20018
2021-08-06,20,10203,4123,4275,1045,1,84,19731
2021-08-06,21,10205,3545,4311,1217,0,85,19363
2021-08-06,22,10204,3061,3969,1196,0,85,18515
2021-08-06,23,10206,1902,3469,1243,0,66,16886
2021-08-06,24,10187,861,3167,1138,0,54,15407
2021-08-07,1,10197,178,3091,1223,0,53,14742
2021-08-07,2,10203,130,3191,992,0,13,14529
2021-08-07,3,10217,212,3542,769,0,0,14740
2021-08-07,4,10235,283,3451,556,0,0,14525
2021-08-07,5,10238,689,3340,470,1,2,14740
2021-08-07,6,10233,995,3347,425,3,1,15004
2021-08-07,7,10249,1232,3459,393,37,0,15370
2021-08-07,8,10255,2179,3671,295,109,17,16526
2021-08-07,9,10251,2417,3660,236,204,50,16818
2021-08-07,10,10260,2491,3531,218,299,56,16855
2021-08-07,11,10255,2686,3700,301,350,54,17346
2021-08-07,12,10254,3631,3692,339,323,61,18300
2021-08-07,13,10248,4063,3743,392,300,44,18790
2021-08-07,14,10236,3899,3506,392,309,0,18342
2021-08-07,15,10228,3434,3714,495,315,0,18186
2021-08-07,16,10236,3655,4336,376,218,0,18821
2021-08-07,17,10267,4005,4626,385,154,0,19437
2021-08-07,18,10270,4002,4818,258,92,0,19440
2021-08-07,19,10265,4121,4691,186,30,0,19293
2021-08-07,20,10264,4274,4201,177,3,0,18919
2021-08-07,21,10260,3873,3799,233,0,0,18165
2021-08-07,22,10258,2952,3431,265,0,0,16906
2021-08-07,23,10269,1777,3250,306,0,0,15602
2021-08-07,24,10277,1053,3117,459,0,0,14906
2021-08-08,1,10274,262,3092,521,0,0,14149
2021-08-08,2,10271,133,2911,538,0,0,13853
2021-08-08,3,10263,144,2723,362,0,0,13492
2021-08-08,4,10264,262,2884,445,0,0,13855
2021-08-08,5,10275,515,3163,410,0,0,14363
2021-08-08,6,10274,945,3231,442,3,0,14895
2021-08-08,7,10265,1093,3202,507,33,0,15100
2021-08-08,8,10251,1477,3204,515,100,0,15547
2021-08-08,9,10254,2027,3284,439,136,0,16140
2021-08-08,10,10247,2276,3331,499,220,0,16573
2021-08-08,11,10244,2676,3298,598,306,0,17122
2021-08-08,12,10256,2747,3869,544,339,0,17755
2021-08-08,13,10248,3283,3971,698,261,0,18461
2021-08-08,14,10213,3695,3890,781,254,1,18834
2021-08-08,15,10200,3563,3951,828,211,6,18759
2021-08-08,16,10207,3652,4190,881,199,33,19162
2021-08-08,17,10212,3774,4584,1064,140,53,19827
2021-08-08,18,10212,3473,4585,1084,79,55,19488
2021-08-08,19,10212,3364,4609,1014,27,56,19282
2021-08-08,20,10211,3297,4546,1124,0,56,19234
2021-08-08,21,10201,3132,4071,1287,0,13,18704
2021-08-08,22,10199,2557,3489,1499,0,0,17744
2021-08-08,23,10195,1780,2998,1361,0,0,16334
2021-08-08,24,10186,1269,2940,1060,0,0,15455
2021-08-09,1,10178,1222,2780,1087,0,7,15274
2021-08-09,2,10174,1222,2692,1339,0,16,15443
2021-08-09,3,10181,1321,3185,1079,0,18,15784
2021-08-09,4,10179,1519,3174,954,0,18,15844
2021-08-09,5,10169,1432,3129,894,0,21,15645
2021-08-09,6,10171,1915,3257,1009,2,34,16388
2021-08-09,7,10167,2333,3321,968,15,68,16872
2021-08-09,8,10168,2612,3625,794,82,87,17368
2021-08-09,9,10164,3003,3762,698,188,87,17902
2021-08-09,10,10147,3592,4118,753,273,87,18970
2021-08-09,11,10141,4379,4035,911,330,91,19887
2021-08-09,12,10149,4773,4085,1270,341,94,20712
2021-08-09,13,10157,4396,4176,1545,333,102,20709
2021-08-09,14,10145,4823,4376,1659,307,60,21370
2021-08-09,15,10134,5465,4496,1354,257,52,21758
2021-08-09,16,10119,6027,4631,1052,222,51,22102
2021-08-09,17,10108,5714,5119,697,172,48,21858
2021-08-09,18,10131,5498,5171,660,79,45,21584
2021-08-09,19,10136,4768,5109,943,19,47,21022
2021-08-09,20,10131,4698,4945,1015,0,46,20835
2021-08-09,21,10130,4840,4519,1194,0,42,20725
2021-08-09,22,10117,4055,3846,1413,0,33,19464
2021-08-09,23,10119,3216,3279,1492,0,21,18127
2021-08-09,24,10118,1904,3281,1603,0,17,16923
2021-08-10,1,10116,1377,3241,1543,0,15,16292
2021-08-10,2,10111,1378,3124,1627,0,15,16255
2021-08-10,3,10108,1354,3222,1632,0,15,16331
2021-08-10,4,10107,1544,3019,1930,0,17,16617
2021-08-10,5,10105,1757,2846,2079,0,22,16809
2021-08-10,6,10101,2213,2791,1861,3,26,16995
2021-08-10,7,10093,2582,2957,1591,26,31,17280
2021-08-10,8,10082,2569,3117,1883,73,31,17755
2021-08-10,9,10064,2855,3498,2261,112,32,18822
2021-08-10,10,10055,3398,3804,2291,111,31,19690
2021-08-10,11,10054,4367,3840,1914,176,31,20382
2021-08-10,12,10054,4292,4019,1968,289,31,20653
2021-08-10,13,10047,4078,3861,2122,315,36,20459
2021-08-10,14,10037,4288,3869,1996,268,42,20500
2021-08-10,15,10038,4323,4170,1735,254,42,20562
2021-08-10,16,10034,4321,4615,1662,222,33,20887
2021-08-10,17,10041,4683,4615,1703,150,32,21224
2021-08-10,18,10040,4720,4798,1403,83,31,21075
2021-08-10,19,10037,5271,4662,1000,25,33,21028
2021-08-10,20,10027,5119,4653,919,0,30,20748
2021-08-10,21,10032,4999,4565,1009,0,31,20636
2021-08-10,22,10024,4464,3771,1153,0,31,19443
2021-08-10,23,10036,3314,3455,1207,0,23,18035
2021-08-10,24,10040,2130,3166,1310,0,16,16662
2021-08-11,1,10042,1855,2886,1575,0,15,16373
2021-08-11,2,10045,1851,2659,1674,0,15,16244
2021-08-11,3,10043,1866,2647,1769,0,15,16340
2021-08-11,4,10043,1881,2774,1810,0,16,16524
2021-08-11,5,10050,2368,3253,1329,0,23,17023
2021-08-11,6,10049,2687,3150,1121,2,28,17037
2021-08-11,7,10045,3000,3085,1168,16,30,17344
2021-08-11,8,10030,3026,3197,1523,62,30,17868
2021-08-11,9,10030,3286,3497,1595,166,30,18604
2021-08-11,10,10034,4003,3655,1565,246,33,19536
2021-08-11,11,10025,5196,3869,1648,311,32,21081
2021-08-11,12,10031,5406,4046,1640,341,46,21510
2021-08-11,13,10025,5468,4265,1857,339,45,21999
2021-08-11,14,10028,5395,4405,2255,331,45,22459
2021-08-11,15,10037,5022,4520,2500,337,45,22461
2021-08-11,16,10028,5016,4451,2619,255,46,22415
2021-08-11,17,9994,4750,4758,2151,142,39,21834
2021-08-11,18,9990,4751,4537,2091,49,42,21460
2021-08-11,19,9984,4093,4620,1738,13,42,20490
2021-08-11,20,9959,4443,4512,1899,1,33,20847
2021-08-11,21,9971,4663,4354,2264,0,32,21284
2021-08-11,22,9987,3639,3665,2585,0,32,19908
2021-08-11,23,10005,2240,3020,2561,0,25,17851
2021-08-11,24,10004,1202,2771,2907,0,18,16902
2021-08-12,1,9990,1213,2801,2554,0,15,16573
2021-08-12,2,9988,1380,2731,2486,0,15,16600
2021-08-12,3,10020,1384,2734,2435,0,15,16588
2021-08-12,4,10029,1491,2692,2343,0,15,16570
2021-08-12,5,10042,1659,2744,2298,0,19,16762
2021-08-12,6,10059,1920,2778,2187,2,30,16976
2021-08-12,7,10062,2363,2904,1965,16,31,17341
2021-08-12,8,10063,2745,3041,2221,61,31,18162
2021-08-12,9,10054,3160,3284,2153,112,31,18794
2021-08-12,10,10039,3435,3450,2380,182,31,19517
2021-08-12,11,10041,4047,4134,1647,247,31,20147
2021-08-12,12,10044,4872,4314,1242,273,30,20775
2021-08-12,13,10055,5036,4398,1130,296,34,20949
2021-08-12,14,10055,5063,4414,1148,335,45,21060
2021-08-12,15,10076,5094,4585,1207,337,79,21378
2021-08-12,16,10099,5229,4807,1295,300,101,21831
2021-08-12,17,10107,5411,5070,1256,202,104,22150
2021-08-12,18,10105,5506,5027,1126,97,103,21964
2021-08-12,19,10103,5587,4787,1129,26,101,21733
2021-08-12,20,10107,5293,4581,1257,0,92,21330
2021-08-12,21,10113,4954,4491,1529,0,47,21134
2021-08-12,22,10120,3671,3673,2018,0,32,19514
2021-08-12,23,10130,2681,2856,2353,0,22,18042
2021-08-12,24,10143,1884,2740,2226,0,15,17008
2021-08-13,1,10150,1774,2745,2025,0,15,16709
2021-08-13,2,10160,1984,2605,1837,0,15,16601
2021-08-13,3,10165,2146,2955,1540,0,15,16821
2021-08-13,4,10167,2178,3145,1223,0,15,16728
2021-08-13,5,10161,2567,3243,940,1,18,16930
2021-08-13,6,10162,2762,3174,912,2,27,17039
2021-08-13,7,10155,3187,3378,758,25,32,17535
2021-08-13,8,10135,3891,3625,540,103,31,18325
2021-08-13,9,10116,4511,4157,429,171,31,19415
2021-08-13,10,10114,5032,4822,424,179,34,20605
2021-08-13,11,10125,5346,4391,556,163,34,20615
2021-08-13,12,10111,5465,4479,762,175,54,21046
2021-08-13,13,10110,5207,4605,837,224,58,21041
2021-08-13,14,10095,5189,4700,932,254,58,21228
2021-08-13,15,10093,5229,4709,999,266,59,21355
2021-08-13,16,10088,4860,4645,1089,216,44,20942
2021-08-13,17,10086,4912,4791,1163,151,33,21136
2021-08-13,18,10097,5371,4614,941,82,31,21136
2021-08-13,19,10098,5489,4468,809,24,31,20919
2021-08-13,20,10098,4956,4262,744,0,31,20091
2021-08-13,21,10107,4236,3900,636,0,31,18910
2021-08-13,22,10148,3368,3640,574,0,31,17761
2021-08-13,23,10164,2591,3629,635,0,16,17035
2021-08-13,24,10164,1412,3080,640,0,1,15297
2021-08-14,1,10190,874,3003,523,0,0,14590
2021-08-14,2,10190,616,3000,635,0,0,14441
2021-08-14,3,10185,525,2984,673,0,0,14367
2021-08-14,4,10175,504,2806,756,0,0,14241
2021-08-14,5,10173,502,2752,916,1,0,14344
2021-08-14,6,10170,518,2742,1085,2,0,14517
2021-08-14,7,10159,524,2978,861,30,0,14552
2021-08-14,8,10146,661,3469,676,125,0,15077
2021-08-14,9,10157,702,3535,608,275,0,15277
2021-08-14,10,10180,1040,3394,745,373,0,15732
2021-08-14,11,10187,1346,3634,774,387,0,16328
2021-08-14,12,10204,1652,3864,832,391,1,16944
2021-08-14,13,10217,1752,3542,945,396,1,16853
2021-08-14,14,10229,1719,3613,1099,377,0,17037
2021-08-14,15,10219,1713,4080,1108,375,0,17495
2021-08-14,16,10223,1468,4184,1111,316,0,17302
2021-08-14,17,10228,1733,4576,1118,204,0,17859
2021-08-14,18,10233,1866,4559,1014,111,0,17783
2021-08-14,19,10226,1864,4508,738,23,0,17359
2021-08-14,20,10219,1736,4153,628,0,0,16736
2021-08-14,21,10216,1221,3691,767,0,0,15895
2021-08-14,22,10212,1107,3211,744,0,1,15275
2021-08-14,23,10213,598,2836,564,0,1,14212
2021-08-14,24,10221,195,2988,586,0,0,13990
2021-08-15,1,10209,131,2959,572,0,0,13871
2021-08-15,2,10212,131,2917,526,0,0,13786
2021-08-15,3,10196,131,2984,520,0,0,13831
2021-08-15,4,10189,131,2823,566,0,0,13709
2021-08-15,5,10202,131,2804,351,1,0,13489
2021-08-15,6,10232,134,2748,458,4,0,13576
2021-08-15,7,10248,141,2938,622,42,0,13991
2021-08-15,8,10248,221,3327,503,145,0,14444
2021-08-15,9,10245,510,3616,248,274,0,14893
2021-08-15,10,10246,896,3812,226,366,0,15546
2021-08-15,11,10245,1233,3836,244,369,0,15927
2021-08-15,12,10242,1300,3663,302,394,0,15901
2021-08-15,13,10243,1563,3892,390,384,0,16472
2021-08-15,14,10232,1610,3872,448,414,0,16576
2021-08-15,15,10210,1799,3981,458,409,0,16857
2021-08-15,16,10187,1939,4030,392,316,0,16864
2021-08-15,17,10191,2139,4654,378,219,2,17583
2021-08-15,18,10207,2568,4473,383,109,1,17741
2021-08-15,19,10236,2132,4458,357,24,7,17214
2021-08-15,20,10256,2413,4395,326,0,0,17390
2021-08-15,21,10267,1825,4310,475,0,0,16877
2021-08-15,22,10271,1556,3947,528,0,0,16302
2021-08-15,23,10297,719,3518,583,0,0,15117
2021-08-15,24,10286,209,3146,614,0,0,14255
2021-08-16,1,10291,131,3102,616,0,9,14149
2021-08-16,2,10304,159,3015,666,0,13,14157
2021-08-16,3,10299,179,3014,800,0,18,14310
2021-08-16,4,10306,432,2903,734,0,18,14393
2021-08-16,5,10324,777,2847,716,1,18,14683
2021-08-16,6,10326,1099,2734,575,5,24,14763
2021-08-16,7,10311,1271,3047,554,43,31,15257
2021-08-16,8,10310,1635,3300,384,135,32,15796
2021-08-16,9,10292,2349,3702,281,207,31,16862
2021-08-16,10,10271,2734,3918,205,258,33,17419
2021-08-16,11,10253,2769,3707,182,282,34,17227
2021-08-16,12,10251,3044,3687,291,320,55,17648
2021-08-16,13,10258,3082,3833,353,284,53,17863
2021-08-16,14,10256,3534,3832,369,295,53,18339
2021-08-16,15,10265,3631,3838,341,273,51,18399
2021-08-16,16,10265,3585,4182,360,195,51,18638
2021-08-16,17,10271,3684,4459,384,115,48,18961
2021-08-16,18,10277,3864,4459,372,72,42,19086
2021-08-16,19,10280,3401,4456,315,23,32,18507
2021-08-16,20,10290,3472,4390,259,0,32,18443
2021-08-16,21,10281,3409,3858,249,0,32,17829
2021-08-16,22,10280,3087,3595,294,0,32,17288
2021-08-16,23,10278,2803,3366,368,0,23,16838
2021-08-16,24,10274,1458,2994,422,0,17,15165
2021-08-17,1,10264,892,3280,364,0,17,14817
2021-08-17,2,10262,848,3121,340,0,17,14588
2021-08-17,3,10261,923,2824,331,0,17,14356
2021-08-17,4,10282,1096,2926,226,0,18,14548
2021-08-17,5,10308,1298,3123,169,0,20,14918
2021-08-17,6,10307,1754,3139,183,2,26,15411
2021-08-17,7,10305,2489,3211,174,8,31,16218
2021-08-17,8,10302,2805,3457,128,38,31,16761
2021-08-17,9,10295,3179,3628,112,90,31,17335
2021-08-17,10,10286,3564,3777,103,150,31,17911
2021-08-17,11,10267,4111,3935,148,201,31,18693
2021-08-17,12,10283,4520,4004,176,245,31,19259
2021-08-17,13,10281,4955,4295,179,248,34,19992
2021-08-17,14,10271,5221,4082,186,285,33,20078
2021-08-17,15,10268,5188,4287,192,250,31,20216
2021-08-17,16,10263,5217,4498,202,189,31,20400
2021-08-17,17,10274,5155,4677,185,154,31,20476
2021-08-17,18,10273,5306,4639,170,79,32,20499
2021-08-17,19,10270,5315,4607,190,25,32,20439
2021-08-17,20,10266,5501,4407,175,0,32,20381
2021-08-17,21,10262,5461,4242,219,0,32,20216
2021-08-17,22,10249,4699,3738,223,0,32,18941
2021-08-17,23,10227,3872,3539,248,0,24,17910
2021-08-17,24,10217,2681,3414,241,0,19,16572
2021-08-18,1,10206,2011,3197,207,0,17,15638
2021-08-18,2,10194,1940,3143,167,0,17,15461
2021-08-18,3,10198,2034,3118,143,0,17,15510
2021-08-18,4,10211,2181,3074,155,0,17,15638
2021-08-18,5,10212,2326,2685,114,1,21,15359
2021-08-18,6,10213,2538,2809,237,2,29,15828
2021-08-18,7,10199,2828,3003,265,10,32,16337
2021-08-18,8,10205,3185,3411,291,51,32,17175
2021-08-18,9,10214,3884,3558,250,106,35,18047
2021-08-18,10,10211,4258,3592,276,140,34,18511
2021-08-18,11,10221,4769,3518,315,183,32,19038
2021-08-18,12,10225,4919,3805,294,201,31,19475
2021-08-18,13,10230,5209,3955,200,192,31,19817
2021-08-18,14,10235,5910,4139,143,194,32,20653
2021-08-18,15,10236,6152,4181,218,162,36,20985
2021-08-18,16,10246,5918,4309,402,122,42,21039
2021-08-18,17,10245,5360,4493,549,92,42,20781
2021-08-18,18,10254,5183,4511,592,57,41,20638
2021-08-18,19,10264,5296,4664,503,17,41,20785
2021-08-18,20,10262,5929,4590,435,0,30,21246
2021-08-18,21,10257,5767,4242,395,0,30,20691
2021-08-18,22,10250,4520,3941,342,0,31,19084
2021-08-18,23,10259,3500,3770,294,0,25,17848
2021-08-18,24,10263,2390,3738,315,0,22,16728
2021-08-19,1,10269,1960,3255,308,0,19,15811
2021-08-19,2,10268,1847,3007,324,0,18,15464
2021-08-19,3,10268,1848,2977,332,0,17,15442
2021-08-19,4,10294,1961,2959,322,0,17,15553
2021-08-19,5,10305,2200,2722,163,1,21,15412
2021-08-19,6,10303,2417,2847,357,2,30,15956
2021-08-19,7,10301,2807,3335,369,16,31,16859
2021-08-19,8,10296,3189,3903,278,65,32,17763
2021-08-19,9,10294,4643,3876,135,113,36,19097
2021-08-19,10,10279,5323,3718,161,179,33,19693
2021-08-19,11,10270,5674,3789,209,201,32,20175
2021-08-19,12,10252,6134,3908,212,238,32,20776
2021-08-19,13,10242,6052,3749,243,241,33,20560
2021-08-19,14,10231,5996,3872,226,261,46,20632
2021-08-19,15,10221,6457,4170,259,255,41,21403
2021-08-19,16,10212,6225,4582,284,208,40,21551
2021-08-19,17,10213,6139,4661,258,129,38,21438
2021-08-19,18,10222,6159,4630,231,73,37,21352
2021-08-19,19,10235,6250,4689,208,23,38,21443
2021-08-19,20,10249,6317,4404,182,0,39,21191
2021-08-19,21,10264,6237,4197,184,0,37,20919
2021-08-19,22,10284,5197,3877,141,0,32,19531
2021-08-19,23,10293,3922,3446,221,0,25,17907
2021-08-19,24,10296,3123,3250,222,0,20,16911
2021-08-20,1,10311,2628,2816,132,0,17,15904
2021-08-20,2,10307,2150,2712,87,0,17,15273
2021-08-20,3,10300,2126,2703,86,0,16,15231
2021-08-20,4,10298,2513,2736,96,0,17,15660
2021-08-20,5,10282,2719,2829,121,2,21,15974
2021-08-20,6,10278,2963,2834,138,2,26,16241
2021-08-20,7,10277,3273,3061,141,22,31,16805
2021-08-20,8,10266,3669,3282,70,90,32,17409
2021-08-20,9,10273,4357,3592,17,215,32,18486
2021-08-20,10,10277,5123,3629,8,315,33,19385
2021-08-20,11,10273,5686,3713,9,385,34,20100
2021-08-20,12,10271,6112,4007,31,382,35,20838
2021-08-20,13,10249,6030,4069,55,390,32,20825
2021-08-20,14,10228,6194,4146,104,367,43,21082
2021-08-20,15,10209,5739,4207,141,336,40,20672
2021-08-20,16,10211,5571,4621,122,258,42,20825
2021-08-20,17,10215,5587,4892,98,166,42,21000
2021-08-20,18,10234,5408,4725,71,76,44,20558
2021-08-20,19,10232,5515,4720,51,16,42,20576
2021-08-20,20,10234,6174,4453,66,0,31,20958
2021-08-20,21,10240,6200,4011,96,0,27,20574
2021-08-20,22,10254,5464,3690,79,0,27,19514
2021-08-20,23,10280,4125,3330,103,0,21,17859
2021-08-20,24,10284,3209,3297,160,0,16,16966
2021-08-21,1,10284,2660,3267,232,0,14,16457
2021-08-21,2,10284,2379,2942,255,0,0,15860
2021-08-21,3,10284,2379,2729,192,0,0,15584
2021-08-21,4,10286,2380,2958,178,0,0,15802
2021-08-21,5,10281,2490,2972,173,1,0,15917
2021-08-21,6,10281,2629,3014,172,5,0,16101
2021-08-21,7,10276,2863,2816,133,14,0,16102
2021-08-21,8,10272,3163,2867,140,75,0,16517
2021-08-21,9,10267,3567,3084,131,168,0,17217
2021-08-21,10,10256,4752,3544,135,246,0,18933
2021-08-21,11,10270,5676,3803,140,294,0,20183
2021-08-21,12,10261,6131,3966,156,321,0,20835
2021-08-21,13,10233,6334,4052,209,317,3,21148
2021-08-21,14,10230,6040,3977,261,280,3,20791
2021-08-21,15,10226,5657,4062,337,221,16,20519
2021-08-21,16,10213,5596,4216,306,163,23,20517
2021-08-21,17,10217,5730,4592,232,111,18,20900
2021-08-21,18,10217,5662,4394,255,54,17,20599
2021-08-21,19,10231,5372,4348,230,12,14,20207
2021-08-21,20,10238,5263,4165,181,0,3,19850
2021-08-21,21,10242,5029,3656,184,0,7,19118
2021-08-21,22,10251,4749,3482,217,0,3,18702
2021-08-21,23,10262,3544,3325,281,0,0,17412
2021-08-21,24,10270,3064,3178,308,0,0,16820
2021-08-22,1,10278,2419,2655,229,0,0,15581
2021-08-22,2,10275,2034,2864,321,0,0,15494
2021-08-22,3,10275,2022,2594,357,0,0,15248
2021-08-22,4,10273,2005,2576,403,0,0,15257
2021-08-22,5,10267,2045,2821,357,0,0,15490
2021-08-22,6,10262,2160,2950,277,2,0,15651
2021-08-22,7,10265,2418,2924,211,17,0,15835
2021-08-22,8,10266,2841,2977,89,94,0,16267
2021-08-22,9,10271,3314,3082,65,186,0,16918
2021-08-22,10,10251,3973,3293,72,246,0,17835
2021-08-22,11,10224,4969,3529,120,264,0,19106
2021-08-22,12,10191,5419,3834,90,289,0,19823
2021-08-22,13,10185,5729,3904,159,278,0,20255
2021-08-22,14,10201,5732,3840,276,241,0,20290
2021-08-22,15,10227,5531,3708,393,284,1,20144
2021-08-22,16,10228,5144,3974,268,269,10,19893
2021-08-22,17,10226,5268,4177,290,159,25,20145
2021-08-22,18,10231,5288,4254,254,72,24,20123
2021-08-22,19,10232,5258,4090,256,15,20,19871
2021-08-22,20,10240,5376,3940,275,0,7,19838
2021-08-22,21,10258,5268,3797,394,0,0,19717
2021-08-22,22,10282,4590,3354,465,0,1,18692
2021-08-22,23,10295,3560,3241,532,0,15,17643
2021-08-22,24,10307,3169,3059,534,0,43,17112
2021-08-23,1,10309,3073,2908,463,0,66,16819
2021-08-23,2,10311,2997,2701,336,0,53,16398
2021-08-23,3,10307,3010,2608,302,0,50,16277
2021-08-23,4,10292,3027,2615,253,0,71,16258
2021-08-23,5,10257,3177,2888,288,1,71,16682
2021-08-23,6,10253,3475,2997,283,2,125,17135
2021-08-23,7,10257,3981,3092,267,24,89,17710
2021-08-23,8,10263,4521,3222,155,109,81,18351
2021-08-23,9,10248,5253,3328,88,204,78,19199
2021-08-23,10,10245,5789,3422,113,302,94,19965
2021-08-23,11,10254,5908,3701,177,329,93,20462
2021-08-23,12,10252,6123,3743,214,295,84,20711
2021-08-23,13,10237,5911,3836,269,301,78,20632
2021-08-23,14,10223,5737,3912,309,299,87,20567
2021-08-23,15,10216,5645,3988,356,246,82,20533
2021-08-23,16,10207,5527,4345,407,189,96,20771
2021-08-23,17,10198,5912,4446,424,141,96,21217
2021-08-23,18,10215,5683,4391,442,64,94,20889
2021-08-23,19,10238,5547,4355,385,10,94,20629
2021-08-23,20,10257,5859,4037,396,0,92,20641
2021-08-23,21,10273,5741,3590,511,0,73,20188
2021-08-23,22,10294,4645,3261,536,0,74,18810
2021-08-23,23,10329,3931,2788,398,0,61,17507
2021-08-23,24,10335,3447,2619,376,0,58,16835
2021-08-24,1,10340,2586,2796,424,0,59,16205
2021-08-24,2,10332,2644,2504,336,0,59,15875
2021-08-24,3,10312,2817,2581,303,0,59,16072
2021-08-24,4,10305,2921,2547,305,0,60,16138
2021-08-24,5,10292,3084,2610,199,0,62,16247
2021-08-24,6,10258,3275,2629,125,0,73,16360
2021-08-24,7,10231,3455,2799,179,25,74,16763
2021-08-24,8,10223,4087,3461,98,119,74,18062
2021-08-24,9,10241,5278,3383,38,232,74,19246
2021-08-24,10,10257,6114,3414,38,311,74,20208
2021-08-24,11,10259,6264,3463,126,347,81,20540
2021-08-24,12,10266,6462,3746,295,356,84,21209
2021-08-24,13,10269,6177,3865,483,358,91,21243
2021-08-24,14,10264,6371,4005,630,357,95,21722
2021-08-24,15,10253,6557,4085,633,325,95,21948
2021-08-24,16,10236,6976,4159,575,254,96,22296
2021-08-24,17,10247,6963,4300,488,168,98,22264
2021-08-24,18,10275,6660,4232,313,67,94,21641
2021-08-24,19,10202,6522,4330,205,12,99,21370
2021-08-24,20,10149,6805,4127,200,0,92,21373
2021-08-24,21,10132,6766,3773,281,0,78,21030
2021-08-24,22,10106,5975,3277,816,0,74,20248
2021-08-24,23,10100,5211,3207,698,0,61,19277
2021-08-24,24,10080,3629,2881,913,0,60,17563
2021-08-25,1,10090,2827,2916,786,0,60,16679
2021-08-25,2,10094,2909,2593,671,0,60,16327
2021-08-25,3,10094,3121,2528,717,0,60,16520
2021-08-25,4,10100,3124,2738,428,0,59,16449
2021-08-25,5,10110,3224,2742,366,0,59,16501
2021-08-25,6,10105,3406,2455,734,1,66,16767
2021-08-25,7,10100,3673,2732,543,16,72,17136
2021-08-25,8,10077,4377,3350,425,88,72,18389
2021-08-25,9,10055,5559,3456,408,171,72,19721
2021-08-25,10,10051,6011,3457,516,229,77,20341
2021-08-25,11,10059,5970,3435,404,259,82,20209
2021-08-25,12,10048,5760,3897,517,276,79,20577
2021-08-25,13,10018,6233,3909,493,235,80,20968
2021-08-25,14,10014,6228,3944,529,217,81,21013
2021-08-25,15,10007,6186,4050,561,197,82,21083
2021-08-25,16,10043,6428,4114,557,161,83,21386
2021-08-25,17,10123,6270,4187,535,106,85,21306
2021-08-25,18,10167,5902,4256,470,50,87,20932
2021-08-25,19,10159,5878,4494,461,11,84,21087
2021-08-25,20,10148,6379,4018,653,0,82,21280
2021-08-25,21,10166,5875,3419,819,0,77,20356
2021-08-25,22,10213,5088,3177,784,0,76,19338
2021-08-25,23,10236,4217,3111,818,0,66,18448
2021-08-25,24,10230,3603,3137,818,0,60,17848
2021-08-26,1,10218,3470,3022,796,0,58,17564
2021-08-26,2,10196,3335,2835,724,0,58,17148
2021-08-26,3,10197,3406,2776,675,0,59,17113
2021-08-26,4,10194,3561,2898,574,0,61,17288
2021-08-26,5,10210,3497,2591,597,0,67,16962
2021-08-26,6,10220,3542,2658,604,1,71,17096
2021-08-26,7,10218,3923,3127,677,15,75,18035
2021-08-26,8,10196,4980,3302,448,82,75,19083
2021-08-26,9,10193,5803,3203,258,160,76,19693
2021-08-26,10,10221,6250,3347,135,220,80,20253
2021-08-26,11,10239,6395,3494,127,260,81,20596
2021-08-26,12,10240,6396,3726,119,297,88,20866
2021-08-26,13,10226,6283,3636,148,302,88,20683
2021-08-26,14,10229,6481,3870,269,279,86,21214
2021-08-26,15,10231,6362,3970,394,248,86,21291
2021-08-26,16,10228,6151,4129,541,181,87,21317
2021-08-26,17,10219,5806,4466,585,109,90,21275
2021-08-26,18,10210,5864,4303,539,37,99,21052
2021-08-26,19,10205,5477,4134,607,11,99,20533
2021-08-26,20,10199,5358,4066,568,0,95,20286
2021-08-26,21,10201,5847,3621,475,0,78,20222
2021-08-26,22,10212,5584,3370,460,0,76,19702
2021-08-26,23,10226,4450,3138,565,0,65,18444
2021-08-26,24,10263,3514,3016,729,0,60,17582
2021-08-27,1,10276,2776,2597,810,0,58,16517
2021-08-27,2,10260,2671,2488,896,0,59,16374
2021-08-27,3,10247,2669,2381,985,0,61,16343
2021-08-27,4,10249,2680,2343,1041,0,64,16377
2021-08-27,5,10253,2775,2398,730,1,68,16225
2021-08-27,6,10269,2946,2439,649,1,74,16378
2021-08-27,7,10247,3148,2765,1292,17,77,17546
2021-08-27,8,10244,3249,3082,1284,90,77,18026
2021-08-27,9,10250,3528,3410,1026,177,66,18457
2021-08-27,10,10151,4596,3453,802,246,56,19304
2021-08-27,11,10224,5050,3376,790,281,56,19777
2021-08-27,12,10204,5016,3424,783,300,55,19782
2021-08-27,13,10122,5448,3555,809,283,56,20273
2021-08-27,14,10082,5410,3787,945,262,62,20548
2021-08-27,15,10061,5249,4014,929,260,77,20590
2021-08-27,16,10028,5765,4063,839,192,78,20965
2021-08-27,17,10000,5415,4053,777,104,78,20427
2021-08-27,18,9977,4692,4058,907,48,77,19759
2021-08-27,19,9962,4853,3809,1149,11,77,19861
2021-08-27,20,9973,4941,3752,1444,0,102,20212
2021-08-27,21,9996,4430,3499,1774,0,104,19803
2021-08-27,22,10029,2923,3019,1900,0,101,17972
2021-08-27,23,10033,1970,2935,1825,0,87,16850
2021-08-27,24,9986,1525,2620,1692,0,82,15905
2021-08-28,1,9958,975,2752,1662,0,76,15423
2021-08-28,2,9692,1057,2822,1616,0,54,15241
2021-08-28,3,9569,1025,2770,1548,0,47,14959
2021-08-28,4,9554,1068,2668,1376,0,46,14712
2021-08-28,5,9518,1077,2839,1190,0,46,14670
2021-08-28,6,9468,1114,2957,1018,1,46,14604
2021-08-28,7,9449,1404,2813,758,15,53,14492
2021-08-28,8,9449,2051,3037,581,71,49,15238
2021-08-28,9,9433,3087,3238,340,151,46,16295
2021-08-28,10,9438,4184,3188,321,202,46,17379
2021-08-28,11,9448,4801,3319,256,288,47,18159
2021-08-28,12,9457,5287,3432,337,304,47,18864
2021-08-28,13,9462,5509,3739,411,335,54,19510
2021-08-28,14,9464,5721,3661,393,316,58,19613
2021-08-28,15,9454,5655,3850,422,267,47,19695
2021-08-28,16,9446,5805,4178,567,199,47,20242
2021-08-28,17,9440,5455,4223,626,143,47,19934
2021-08-28,18,9439,5311,4110,432,50,46,19388
2021-08-28,19,9439,5061,3820,449,10,47,18826
2021-08-28,20,9419,4917,3703,769,0,55,18863
2021-08-28,21,9395,4547,3242,755,0,58,17997
2021-08-28,22,9400,4351,3337,570,0,69,17727
2021-08-28,23,9396,3176,3152,699,0,77,16500
2021-08-28,24,9392,2444,3123,703,0,77,15739
2021-08-29,1,9398,2094,2692,838,0,75,15097
2021-08-29,2,9397,2059,2707,1009,0,76,15248
2021-08-29,3,9408,2169,2952,860,0,75,15464
2021-08-29,4,9419,2373,2930,906,0,86,15714
2021-08-29,5,9420,2381,2767,1138,0,77,15783
2021-08-29,6,9415,2394,2571,1166,2,78,15626
2021-08-29,7,9413,2531,2630,860,9,77,15520
2021-08-29,8,9413,2865,2822,977,64,71,16212
2021-08-29,9,9404,3427,3244,1105,133,72,17385
2021-08-29,10,9397,4269,3502,999,209,82,18458
2021-08-29,11,9419,4893,3433,1048,268,99,19160
2021-08-29,12,9436,4793,3317,1491,298,78,19413
2021-08-29,13,9445,4422,3632,1866,313,76,19754
2021-08-29,14,9438,4303,3757,2108,267,75,19948
2021-08-29,15,9458,4616,3765,2506,264,76,20685
2021-08-29,16,9460,4536,4176,2714,250,76,21212
2021-08-29,17,9457,5171,4259,2339,173,76,21475
2021-08-29,18,9463,5534,3958,2189,67,75,21286
2021-08-29,19,9468,5598,3821,1957,5,76,20925
2021-08-29,20,9465,5539,3312,2206,0,78,20600
2021-08-29,21,9453,4340,3201,2411,0,75,19480
2021-08-29,22,9460,3734,3210,1860,0,80,18344
2021-08-29,23,9478,2882,3131,2045,0,80,17616
2021-08-29,24,9478,2631,2794,1961,0,79,16943
2021-08-30,1,9480,2633,2802,1921,0,81,16917
2021-08-30,2,9480,2630,2857,1786,0,85,16838
2021-08-30,3,9474,2650,3089,1363,0,85,16661
2021-08-30,4,9466,2964,3078,1098,0,86,16692
2021-08-30,5,9486,2804,3086,925,0,88,16389
2021-08-30,6,9492,3118,3080,781,1,101,16573
2021-08-30,7,9501,3555,3163,672,18,107,17016
2021-08-30,8,9504,4135,3329,434,109,99,17610
2021-08-30,9,9503,5053,3271,434,231,144,18636
2021-08-30,10,9522,5113,3212,563,328,157,18895
2021-08-30,11,9550,5254,3240,780,336,156,19316
2021-08-30,12,9552,5506,3375,947,368,153,19901
2021-08-30,13,9556,5805,3580,1005,346,154,20446
2021-08-30,14,9547,5970,3676,1084,302,156,20735
2021-08-30,15,9521,5714,3940,1148,300,106,20729
2021-08-30,16,9520,5502,3998,1061,221,102,20404
2021-08-30,17,9512,5394,4111,960,151,98,20226
2021-08-30,18,9518,4965,4002,811,63,99,19458
2021-08-30,19,9526,4847,3930,721,10,97,19131
2021-08-30,20,9531,4729,3861,708,0,94,18923
2021-08-30,21,9526,4873,3639,674,0,81,18793
2021-08-30,22,9529,3935,3275,649,0,78,17466
2021-08-30,23,9532,3254,3164,594,0,79,16623
2021-08-30,24,9543,2993,3062,515,0,64,16177
2021-08-31,1,9578,2833,2840,596,0,69,15916
2021-08-31,2,9634,2738,2603,765,0,71,15811
2021-08-31,3,9684,2742,2431,803,0,80,15740
2021-08-31,4,9693,2759,2443,764,0,80,15739
2021-08-31,5,9703,2762,2437,415,1,95,15413
2021-08-31,6,9688,2784,2445,464,2,104,15487
2021-08-31,7,9679,2950,2647,386,24,112,15798
2021-08-31,8,9662,3387,3079,309,94,105,16636
2021-08-31,9,9647,3827,3315,117,172,141,17219
2021-08-31,10,9639,4203,3268,141,245,146,17642
2021-08-31,11,9637,4313,3367,251,260,145,17973
2021-08-31,12,9630,4260,3705,336,229,153,18313
2021-08-31,13,9622,4756,3781,425,233,138,18955
2021-08-31,14,9608,5212,3533,611,224,135,19323
2021-08-31,15,9650,4796,3601,756,222,132,19157
2021-08-31,16,9740,4174,4023,828,166,135,19066
2021-08-31,17,9792,4548,4257,819,115,134,19665
2021-08-31,18,9815,4448,4234,852,40,124,19513
2021-08-31,19,9817,3778,3931,963,5,79,18573
2021-08-31,20,9816,3764,3717,1007,0,79,18383
2021-08-31,21,9808,3889,3412,1082,0,81,18272
2021-08-31,22,9808,2777,3191,1181,0,118,17075
2021-08-31,23,9801,1802,2826,1351,0,125,15905
2021-08-31,24,9784,1058,2687,1282,0,68,14879
2021-09-01,1,9772,322,2736,1437,0,63,14330
2021-09-01,2,9763,209,2743,1487,0,63,14265
2021-09-01,3,9758,176,2728,1615,0,68,14345
2021-09-01,4,9772,279,2599,1664,0,74,14388
2021-09-01,5,9850,433,2501,1190,0,88,14062
2021-09-01,6,9926,579,2526,1392,2,97,14522
2021-09-01,7,9959,582,2753,1606,18,99,15017
2021-09-01,8,9949,595,3089,1522,79,90,15324
2021-09-01,9,9938,878,3478,1162,170,134,15760
2021-09-01,10,9926,1058,3367,1206,258,160,15975
2021-09-01,11,9889,1532,2861,1265,326,157,16030
2021-09-01,12,9846,1489,3214,1460,355,156,16520
2021-09-01,13,9820,1868,3334,1519,354,154,17049
2021-09-01,14,9798,2141,3418,1515,362,158,17392
2021-09-01,15,9745,2315,3321,1665,342,157,17545
2021-09-01,16,9733,2302,3299,1898,322,150,17704
2021-09-01,17,9722,2223,3796,2155,221,99,18216
2021-09-01,18,9720,2199,3681,2188,81,92,17961
2021-09-01,19,9733,1905,3802,1779,9,97,17325
2021-09-01,20,9758,1947,3779,1668,0,87,17239
2021-09-01,21,9817,1702,3460,1704,0,81,16764
2021-09-01,22,9863,923,2944,1767,0,119,15616
2021-09-01,23,9865,241,2686,1724,0,112,14628
2021-09-01,24,9872,164,2676,1571,0,67,14350
2021-09-02,1,9851,164,2671,1489,0,66,14241
2021-09-02,2,9851,164,2777,1699,0,66,14557
2021-09-02,3,9852,163,2847,1547,0,66,14475
2021-09-02,4,9860,159,2816,1341,0,67,14243
2021-09-02,5,9899,156,2781,1112,1,68,14017
2021-09-02,6,9907,163,2947,1069,2,76,14164
2021-09-02,7,9900,236,3070,947,28,79,14260
2021-09-02,8,9896,335,3288,686,133,80,14418
2021-09-02,9,9893,575,3442,522,258,80,14770
2021-09-02,10,9920,886,3334,613,318,79,15150
2021-09-02,11,10002,1287,3459,756,364,80,15948
2021-09-02,12,10050,1762,3163,889,374,88,16326
2021-09-02,13,10042,1759,3070,1062,369,133,16435
2021-09-02,14,10039,1760,3094,1116,342,90,16441
2021-09-02,15,10033,1753,3152,1137,334,82,16491
2021-09-02,16,10038,1670,3322,1345,293,82,16750
2021-09-02,17,10048,1568,3592,1252,171,94,16725
2021-09-02,18,10186,1572,3579,947,66,83,16433
2021-09-02,19,10215,1394,3542,944,7,81,16183
2021-09-02,20,10218,1193,3668,912,0,82,16073
2021-09-02,21,10225,1077,3474,906,0,82,15764
2021-09-02,22,10247,418,3371,771,0,82,14889
2021-09-02,23,10239,167,3355,591,0,72,14424
2021-09-02,24,10234,165,3225,500,0,67,14191
2021-09-03,1,10225,162,3016,487,0,67,13957
2021-09-03,2,10222,157,2948,462,0,66,13855
2021-09-03,3,10215,167,2897,406,0,66,13751
2021-09-03,4,10212,271,2988,314,0,66,13851
2021-09-03,5,10237,429,2620,187,0,73,13546
2021-09-03,6,10279,576,2568,183,2,78,13686
2021-09-03,7,10275,579,2945,243,23,81,14146
2021-09-03,8,10269,653,3112,173,96,81,14384
2021-09-03,9,10263,667,3267,83,217,81,14578
2021-09-03,10,10284,874,3162,65,324,82,14791
2021-09-03,11,10298,1092,3145,70,318,114,15037
2021-09-03,12,10312,1044,3334,87,328,119,15224
2021-09-03,13,10292,1055,3569,160,325,95,15496
2021-09-03,14,10272,1424,3558,178,268,106,15806
2021-09-03,15,10258,1617,3727,216,253,85,16156
2021-09-03,16,10247,1746,3859,164,190,84,16290
2021-09-03,17,10241,1792,4321,142,147,83,16726
2021-09-03,18,10251,1692,4308,150,54,81,16536
2021-09-03,19,10274,1595,4015,186,6,82,16158
2021-09-03,20,10274,1602,3691,139,0,118,15824
2021-09-03,21,10267,1775,3516,108,0,83,15749
2021-09-03,22,10252,999,3463,117,0,80,14911
2021-09-03,23,10277,395,3257,142,0,72,14143
2021-09-03,24,10289,246,3082,149,0,52,13818
2021-09-04,1,10329,179,2980,136,0,46,13670
2021-09-04,2,10358,177,3004,126,0,46,13711
2021-09-04,3,10354,211,2930,153,0,46,13694
2021-09-04,4,10329,169,2905,171,0,46,13620
2021-09-04,5,10312,219,2918,189,0,46,13684
2021-09-04,6,10302,194,2893,259,2,47,13697
2021-09-04,7,10294,154,2638,320,27,47,13480
2021-09-04,8,10305,167,2699,300,120,47,13638
2021-09-04,9,10343,281,2912,189,241,48,14014
2021-09-04,10,10364,474,3118,346,325,47,14674
2021-09-04,11,10364,578,3273,578,355,47,15195
2021-09-04,12,10339,634,3368,730,356,47,15474
2021-09-04,13,10305,591,3282,899,371,47,15495
2021-09-04,14,10270,626,3322,993,340,47,15598
2021-09-04,15,10254,619,3625,1050,306,47,15901
2021-09-04,16,10255,676,3924,1051,200,47,16153
2021-09-04,17,10249,902,4253,921,96,47,16468
2021-09-04,18,10242,888,4268,960,34,47,16439
2021-09-04,19,10231,787,3937,1098,3,72,16128
2021-09-04,20,10218,767,3518,1344,0,99,15946
2021-09-04,21,10212,434,3023,1730,0,49,15448
2021-09-04,22,10249,338,2792,1848,0,51,15278
2021-09-04,23,10299,191,2681,1916,0,49,15136
2021-09-04,24,10305,153,2602,1794,0,47,14901
2021-09-05,1,10282,153,2615,1822,0,47,14919
2021-09-05,2,10250,155,3139,1634,0,48,15226
2021-09-05,3,10193,188,3239,1505,0,49,15174
2021-09-05,4,10166,246,3123,1308,0,47,14890
2021-09-05,5,10143,256,3303,1121,0,46,14869
2021-09-05,6,10124,258,3048,1082,1,47,14560
2021-09-05,7,10124,199,2994,1202,5,47,14571
2021-09-05,8,10117,283,2980,1046,46,46,14518
2021-09-05,9,10109,352,2853,1150,111,46,14621
2021-09-05,10,10117,528,2932,1105,189,46,14917
2021-09-05,11,10123,887,2987,1049,231,46,15323
2021-09-05,12,10159,1257,3025,1277,248,46,16012
2021-09-05,13,10229,1293,2877,1557,304,46,16306
2021-09-05,14,10258,1296,2896,1495,319,46,16310
2021-09-05,15,10285,1569,3225,1495,294,47,16915
2021-09-05,16,10288,1712,3598,1596,293,47,17534
2021-09-05,17,10317,2083,3898,1526,178,46,18048
2021-09-05,18,10310,2088,3718,1342,50,46,17554
2021-09-05,19,10298,1761,3302,1307,6,46,16720
2021-09-05,20,10293,1342,2885,1475,0,46,16041
2021-09-05,21,10282,948,2619,1666,0,49,15564
2021-09-05,22,10270,543,2541,1764,0,50,15168
2021-09-05,23,10268,299,2529,1670,0,46,14812
2021-09-05,24,10246,151,2973,1389,0,46,14805
2021-09-06,1,10218,153,3294,1086,0,58,14809
2021-09-06,2,10206,162,3038,1210,0,65,14681
2021-09-06,3,10191,152,2461,1191,0,64,14059
2021-09-06,4,10194,150,2378,1424,0,48,14194
2021-09-06,5,10298,151,2427,1371,0,58,14305
2021-09-06,6,10354,150,2448,1783,1,61,14797
2021-09-06,7,10374,152,2531,1639,14,48,14758
2021-09-06,8,10362,159,2980,1510,65,50,15126
2021-09-06,9,10360,243,3331,1610,146,47,15737
2021-09-06,10,10369,399,2809,1667,239,51,15534
2021-09-06,11,10379,541,2623,1648,315,65,15571
2021-09-06,12,10386,801,2711,1954,341,61,16254
2021-09-06,13,10399,956,2763,1786,307,48,16259
2021-09-06,14,10413,1050,3106,1646,319,47,16581
2021-09-06,15,10420,1098,3260,1514,308,47,16647
2021-09-06,16,10428,1371,3547,1366,256,47,17015
2021-09-06,17,10432,1451,3925,1224,136,47,17215
2021-09-06,18,10441,1286,4215,878,64,47,16931
2021-09-06,19,10444,1171,4173,600,7,47,16442
2021-09-06,20,10445,1141,4032,479,0,47,16144
2021-09-06,21,10440,1163,3509,394,0,47,15553
2021-09-06,22,10415,403,3379,358,0,47,14602
2021-09-06,23,10416,257,3227,360,0,47,14307
2021-09-06,24,10417,248,3099,328,0,47,14139
2021-09-07,1,10429,248,2882,433,0,47,14039
2021-09-07,2,10435,186,2752,582,0,47,14002
2021-09-07,3,10467,207,2638,621,0,50,13983
2021-09-07,4,10462,295,2843,733,0,54,14387
2021-09-07,5,10467,361,2512,504,0,49,13893
2021-09-07,6,10469,360,2492,814,1,60,14196
2021-09-07,7,10467,363,2661,839,18,71,14419
2021-09-07,8,10471,371,2891,941,124,112,14910
2021-09-07,9,10471,448,3369,886,265,84,15523
2021-09-07,10,10464,535,3602,1005,332,102,16040
2021-09-07,11,10455,264,3442,1182,347,103,15793
2021-09-07,12,10424,185,3425,1276,311,104,15725
2021-09-07,13,10423,185,3421,1278,311,104,15722
2021-09-07,14,10417,578,3075,2305,296,102,16773
2021-09-07,15,10415,628,3360,2604,274,87,17368
2021-09-07,16,10402,680,3870,2586,217,78,17833
2021-09-07,17,10404,863,4635,2058,135,100,18195
2021-09-07,18,10400,1221,4065,1887,34,86,17693
2021-09-07,19,10413,1222,3586,2034,1,79,17335
2021-09-07,20,10400,990,3393,2058,0,85,16926
2021-09-07,21,10408,962,3145,1956,0,87,16558
2021-09-07,22,10405,659,3249,1366,0,85,15764
2021-09-07,23,10403,546,2522,1429,0,68,14968
2021-09-07,24,10421,344,2417,1161,0,66,14409
2021-09-08,1,10423,150,2549,1384,0,64,14570
2021-09-08,2,10412,152,2477,1902,0,63,15006
2021-09-08,3,10392,199,2997,1562,0,65,15215
2021-09-08,4,10302,383,3377,1220,0,64,15346
2021-09-08,5,10248,499,3063,1235,0,67,15112
2021-09-08,6,10230,809,3116,1241,0,77,15473
2021-09-08,7,10233,906,3222,1371,4,79,15815
2021-09-08,8,10274,905,3202,1386,30,78,15875
2021-09-08,9,10301,986,3219,1455,114,79,16154
2021-09-08,10,10315,1188,3163,1780,175,79,16700
2021-09-08,11,10327,1101,3011,1988,224,78,16729
2021-09-08,12,10323,858,2807,2414,222,79,16703
2021-09-08,13,10355,965,2705,2540,258,78,16901
2021-09-08,14,10398,1343,2871,2103,276,79,17070
2021-09-08,15,10391,1727,3097,1916,303,79,17513
2021-09-08,16,10383,1978,3417,2117,217,78,18190
2021-09-08,17,10360,1892,3624,2210,149,78,18313
2021-09-08,18,10359,1847,3827,1994,50,79,18156
2021-09-08,19,10355,1848,3822,1785,5,79,17894
2021-09-08,20,10355,1796,3678,1881,0,79,17789
2021-09-08,21,10351,1298,3297,1932,0,90,16968
2021-09-08,22,10356,724,3144,1713,0,83,16020
2021-09-08,23,10382,566,2807,1662,0,74,15491
2021-09-08,24,10387,403,2720,1710,0,64,15284
2021-09-09,1,10404,181,2627,1432,0,63,14707
2021-09-09,2,10409,152,2844,1266,0,66,14737
2021-09-09,3,10413,155,2914,1049,0,66,14597
2021-09-09,4,10409,263,2574,1022,0,65,14333
2021-09-09,5,10405,395,2535,942,0,71,14348
2021-09-09,6,10403,604,2572,880,3,93,14555
2021-09-09,7,10400,633,2911,1036,13,104,15097
2021-09-09,8,10396,638,3213,787,114,106,15254
2021-09-09,9,10381,675,3269,784,232,80,15421
2021-09-09,10,10377,669,3114,1009,337,80,15586
2021-09-09,11,10373,668,3001,1125,303,136,15606
2021-09-09,12,10369,339,3067,1221,304,59,15359
2021-09-09,13,10352,401,3261,1194,279,69,15556
2021-09-09,14,10344,649,3232,1401,263,106,15995
2021-09-09,15,10360,1101,3390,1052,198,123,16224
2021-09-09,16,10369,1397,3667,1183,123,87,16826
2021-09-09,17,10301,1504,3996,1106,79,79,17065
2021-09-09,18,10252,1357,4246,897,26,79,16857
2021-09-09,19,10259,1172,4326,598,7,80,16442
2021-09-09,20,10262,1141,4185,483,1,78,16150
2021-09-09,21,10267,1137,3886,464,0,106,15860
2021-09-09,22,10246,724,3316,441,0,84,14811
2021-09-09,23,10265,306,3220,428,0,110,14329
2021-09-09,24,10263,157,2730,442,0,91,13683
2021-09-10,1,10261,157,2659,542,0,68,13687
2021-09-10,2,10259,159,2836,541,0,65,13860
2021-09-10,3,9937,193,2949,542,0,65,13686
2021-09-10,4,9901,321,2854,606,0,65,13747
2021-09-10,5,9896,435,2611,470,0,66,13478
2021-09-10,6,9898,630,2618,490,2,74,13712
2021-09-10,7,9895,722,3042,577,26,78,14340
2021-09-10,8,9892,818,3293,365,133,78,14579
2021-09-10,9,9906,1138,3574,241,274,78,15211
2021-09-10,10,9910,1311,3354,296,366,82,15319
2021-09-10,11,9913,1420,3474,431,373,84,15695
2021-09-10,12,9910,1608,3390,462,330,84,15784
2021-09-10,13,9915,1716,3399,499,324,85,15938
2021-09-10,14,9910,1545,3344,445,250,120,15614
2021-09-10,15,9906,1638,3612,455,247,130,15988
2021-09-10,16,9904,1806,3866,512,247,130,16465
2021-09-10,17,9899,2020,4163,491,149,130,16852
2021-09-10,18,9892,2104,4219,397,45,142,16799
2021-09-10,19,9886,2072,4258,394,3,181,16794
2021-09-10,20,9872,1904,4037,480,0,194,16487
2021-09-10,21,9879,1851,3486,568,0,194,15978
2021-09-10,22,9885,1250,3040,651,0,195,15021
2021-09-10,23,9893,309,2807,960,0,158,14127
2021-09-10,24,9895,153,2505,1135,0,85,13773
2021-09-11,1,9902,150,2402,1142,0,61,13657
2021-09-11,2,9902,151,2521,1237,0,61,13872
2021-09-11,3,9892,150,2399,1693,0,21,14155
2021-09-11,4,9890,150,2569,1722,0,1,14332
2021-09-11,5,9892,149,2504,1937,0,0,14482
2021-09-11,6,9893,149,2486,2058,1,0,14587
2021-09-11,7,9893,149,2456,2127,20,0,14645
2021-09-11,8,9893,149,2675,2263,106,0,15086
2021-09-11,9,9875,196,3197,2322,198,0,15788
2021-09-11,10,9880,237,3074,2841,222,0,16254
2021-09-11,11,9881,161,2508,2816,279,0,15645
2021-09-11,12,9875,155,2595,3189,351,0,16165
2021-09-11,13,9872,150,2677,3238,378,0,16315
2021-09-11,14,9860,149,3023,3251,377,0,16660
2021-09-11,15,9851,150,2913,3369,313,0,16596
2021-09-11,16,9842,150,3126,3279,251,0,16648
2021-09-11,17,9834,150,3438,3589,145,0,17156
2021-09-11,18,9840,150,3656,3631,43,0,17320
2021-09-11,19,9850,150,3813,3622,5,0,17440
2021-09-11,20,9851,149,3716,3614,0,0,17330
2021-09-11,21,9864,150,3285,3605,0,0,16904
2021-09-11,22,9874,150,3112,3599,0,0,16735
2021-09-11,23,9877,149,2897,3494,0,0,16417
2021-09-11,24,9884,149,2636,2993,0,0,15662
2021-09-12,1,9886,150,2583,2867,0,0,15486
2021-09-12,2,9888,150,2610,2711,0,0,15359
2021-09-12,3,9892,149,2517,2486,0,0,15044
2021-09-12,4,9900,149,2445,2219,0,0,14713
2021-09-12,5,9905,149,2628,1968,0,2,14652
2021-09-12,6,9909,161,2875,1722,1,2,14670
2021-09-12,7,9907,150,2693,1570,4,0,14324
2021-09-12,8,9905,214,3245,1464,37,0,14865
2021-09-12,9,9902,376,3629,1299,87,0,15293
2021-09-12,10,9903,431,3451,1274,120,0,15179
2021-09-12,11,9905,662,3350,1044,127,0,15088
2021-09-12,12,9906,1011,3572,769,140,0,15398
2021-09-12,13,9904,1130,3479,735,191,0,15439
2021-09-12,14,9900,1443,3137,889,211,0,15580
2021-09-12,15,9898,1465,3331,914,172,0,15780
2021-09-12,16,9900,1699,3869,765,172,0,16405
2021-09-12,17,9906,2388,4188,556,79,0,17117
2021-09-12,18,9908,2581,4105,478,22,0,17094
2021-09-12,19,9907,2301,4015,439,0,0,16662
2021-09-12,20,9908,1933,3986,260,0,0,16087
2021-09-12,21,9906,1449,3815,261,0,1,15432
2021-09-12,22,9546,1090,3239,475,0,0,14350
2021-09-12,23,9368,663,3087,437,0,0,13555
2021-09-12,24,9770,234,2977,359,0,0,13340
2021-09-13,1,9899,217,3056,222,0,1,13395
2021-09-13,2,9903,226,2770,207,0,11,13117
2021-09-13,3,9902,222,2731,195,0,12,13062
2021-09-13,4,9912,424,2702,215,0,13,13266
2021-09-13,5,9915,687,2611,260,0,16,13489
2021-09-13,6,9914,1283,2498,216,2,19,13932
2021-09-13,7,9905,2158,2602,232,22,27,14946
2021-09-13,8,9903,2296,2686,195,115,27,15222
2021-09-13,9,9902,2384,2809,225,204,32,15556
2021-09-13,10,9905,2431,2693,260,259,27,15575
2021-09-13,11,9895,2436,2888,165,232,29,15645
2021-09-13,12,9877,2201,2841,57,154,32,15162
2021-09-13,13,9895,2117,3255,80,177,28,15552
2021-09-13,14,9895,2231,3489,357,301,31,16304
2021-09-13,15,9894,2384,3393,819,219,32,16741
2021-09-13,16,9888,2455,3573,652,115,31,16714
2021-09-13,17,9886,2532,4139,353,82,28,17020
2021-09-13,18,9880,2557,4189,222,30,27,16905
2021-09-13,19,9880,2659,4035,194,3,27,16798
2021-09-13,20,9876,2731,3812,166,0,30,16615
2021-09-13,21,9884,2078,3672,203,0,29,15866
2021-09-13,22,9888,1110,3656,278,0,27,14959
2021-09-13,23,9894,500,3106,386,0,16,13902
2021-09-13,24,9804,192,2728,533,0,14,13271
2021-09-14,1,9768,156,2531,739,0,10,13204
2021-09-14,2,9772,146,2331,860,0,10,13119
2021-09-14,3,9777,146,2329,1028,0,10,13290
2021-09-14,4,9777,231,2269,1177,0,10,13464
2021-09-14,5,9774,251,2311,888,0,14,13238
2021-09-14,6,9771,407,2364,1011,1,23,13577
2021-09-14,7,9760,559,2618,1387,9,27,14360
2021-09-14,8,9745,567,2746,1330,65,27,14480
2021-09-14,9,9744,566,2833,1429,149,30,14751
2021-09-14,10,9740,632,2760,1741,232,29,15134
2021-09-14,11,9744,659,3278,1342,244,44,15311
2021-09-14,12,9740,913,3289,1668,262,40,15912
2021-09-14,13,9728,915,3340,1854,244,28,16109
2021-09-14,14,9725,1094,3254,2257,228,27,16585
2021-09-14,15,9715,1563,3138,2687,203,27,17333
2021-09-14,16,9704,1860,3426,3212,143,27,18372
2021-09-14,17,9693,1906,3820,3183,112,27,18741
2021-09-14,18,9690,1891,3909,3323,23,27,18863
2021-09-14,19,9677,2090,3974,2917,1,27,18686
2021-09-14,20,9672,1993,3720,2851,1,27,18264
2021-09-14,21,9678,1739,3335,2827,1,27,17607
2021-09-14,22,9676,565,3200,2688,1,27,16157
2021-09-14,23,9668,358,3096,2283,1,16,15422
2021-09-14,24,9655,167,2770,1875,1,11,14479
2021-09-15,1,9653,137,2688,1689,1,10,14178
2021-09-15,2,9652,196,2741,1429,1,11,14030
2021-09-15,3,9651,259,2679,1165,1,11,13766
2021-09-15,4,9650,391,2568,995,1,30,13635
2021-09-15,5,9650,935,2408,500,1,39,13533
2021-09-15,6,9655,1314,2477,345,1,44,13836
2021-09-15,7,9658,1701,2785,312,6,38,14500
2021-09-15,8,9651,1819,2863,305,41,39,14718
2021-09-15,9,9654,1812,3113,281,104,40,15004
2021-09-15,10,9651,2060,3086,194,199,50,15240
2021-09-15,11,9651,2110,3165,185,314,55,15480
2021-09-15,12,9650,2219,3152,250,343,42,15656
2021-09-15,13,9652,2297,3187,273,303,41,15753
2021-09-15,14,9650,2720,3459,288,240,43,16400
2021-09-15,15,9646,2689,3532,296,192,52,16407
2021-09-15,16,9651,2734,3897,389,167,56,16894
2021-09-15,17,9652,3222,4164,229,118,54,17439
2021-09-15,18,9650,3080,4169,167,41,54,17161
2021-09-15,19,9652,3062,4255,175,3,52,17199
2021-09-15,20,9649,2983,4226,203,1,54,17116
2021-09-15,21,9646,2297,3953,141,1,34,16072
2021-09-15,22,9645,1597,3248,147,1,22,14660
2021-09-15,23,9643,1107,2945,186,1,14,13896
2021-09-15,24,9644,515,2589,222,1,9,12980
2021-09-16,1,9632,199,2631,316,1,7,12786
2021-09-16,2,9635,165,2754,294,1,7,12856
2021-09-16,3,9633,180,2897,297,1,7,13015
2021-09-16,4,9629,271,2969,351,1,7,13228
2021-09-16,5,9625,401,2572,380,1,13,12992
2021-09-16,6,9620,603,2727,351,2,26,13329
2021-09-16,7,9626,819,3103,463,18,26,14055
2021-09-16,8,9626,945,3061,548,129,26,14335
2021-09-16,9,9621,1068,3034,388,272,26,14409
2021-09-16,10,9616,1123,3280,356,362,26,14763
2021-09-16,11,9612,1373,3530,405,354,26,15300
2021-09-16,12,9611,1829,3289,493,375,26,15623
2021-09-16,13,9605,1901,3517,632,359,26,16040
2021-09-16,14,9598,1650,3631,710,335,30,15954
2021-09-16,15,9594,1577,3589,791,357,26,15934
2021-09-16,16,9594,1605,4110,871,281,27,16488
2021-09-16,17,9589,1807,4500,867,167,29,16959
2021-09-16,18,9578,1873,4371,840,55,30,16747
2021-09-16,19,9572,1661,4126,899,2,31,16291
2021-09-16,20,9573,1584,3769,1313,1,32,16272
2021-09-16,21,9575,1349,3194,1601,1,32,15752
2021-09-16,22,9575,521,3000,1743,0,32,14871
2021-09-16,23,9577,176,2622,1838,0,24,14237
2021-09-16,24,9583,140,2529,1821,0,17,14090
2021-09-17,1,9587,141,2666,1746,0,16,14156
2021-09-17,2,9600,148,2803,1288,0,16,13855
2021-09-17,3,9596,252,2866,1101,0,16,13831
2021-09-17,4,9596,520,2904,1059,0,12,14091
2021-09-17,5,9591,656,2551,1018,0,10,13826
2021-09-17,6,9600,1222,2398,1204,2,12,14438
2021-09-17,7,9597,1528,2593,1131,18,12,14879
2021-09-17,8,9594,1884,2942,939,97,24,15480
2021-09-17,9,9587,2183,3275,734,181,31,15991
2021-09-17,10,9587,2381,3363,645,254,31,16261
2021-09-17,11,9583,2538,3067,556,309,31,16084
2021-09-17,12,9580,2671,3295,647,320,31,16544
2021-09-17,13,9581,2762,3356,506,334,31,16570
2021-09-17,14,9568,2972,3444,1044,331,31,17390
2021-09-17,15,9564,2987,3600,1292,278,31,17752
2021-09-17,16,9564,3012,4090,1354,225,31,18276
2021-09-17,17,9559,3489,4269,1321,124,31,18793
2021-09-17,18,9555,3471,4169,1187,41,31,18454
2021-09-17,19,9554,3290,4147,1166,0,31,18188
2021-09-17,20,9546,2823,3980,1359,0,31,17739
2021-09-17,21,9546,2408,3683,1449,0,31,17117
2021-09-17,22,9556,1831,3096,1225,0,31,15739
2021-09-17,23,9548,742,3181,1322,0,20,14813
2021-09-17,24,9546,562,2993,1349,0,2,14452
2021-09-18,1,9550,312,2821,1403,0,0,14086
2021-09-18,2,9549,139,3034,1314,0,0,14036
2021-09-18,3,9555,161,2954,1318,0,0,13988
2021-09-18,4,9565,153,2543,1680,0,0,13941
2021-09-18,5,9568,133,2516,1643,0,0,13860
2021-09-18,6,9570,135,2568,1646,2,0,13921
2021-09-18,7,9570,135,2793,1325,7,0,13830
2021-09-18,8,9565,136,2960,1030,68,0,13759
2021-09-18,9,9567,137,3197,952,195,0,14048
2021-09-18,10,9566,142,3431,693,326,0,14158
2021-09-18,11,9564,297,3825,417,372,14,14489
2021-09-18,12,9570,550,3867,365,399,18,14769
2021-09-18,13,9480,557,3606,377,388,22,14430
2021-09-18,14,9573,543,3793,473,365,5,14752
2021-09-18,15,9500,599,4137,672,321,0,15229
2021-09-18,16,9555,987,4155,845,270,0,15812
2021-09-18,17,9563,1176,4125,810,171,9,15854
2021-09-18,18,9570,1258,4145,705,51,13,15742
2021-09-18,19,9569,1194,3920,803,1,25,15512
2021-09-18,20,9566,1150,3636,830,0,28,15210
2021-09-18,21,9570,948,3014,937,0,27,14496
2021-09-18,22,9571,264,3001,1169,0,24,14029
2021-09-18,23,9566,136,2768,1299,0,27,13796
2021-09-18,24,9563,137,2532,1212,0,27,13471
2021-09-19,1,9573,140,2425,1119,0,28,13285
2021-09-19,2,9592,139,2465,1071,0,27,13294
2021-09-19,3,9597,139,2555,1090,0,26,13407
2021-09-19,4,9602,139,2524,1110,0,22,13397
2021-09-19,5,9606,139,2491,1110,0,24,13370
2021-09-19,6,9602,139,2581,1030,3,20,13375
2021-09-19,7,9598,139,2395,1155,21,17,13325
2021-09-19,8,9594,136,2558,1040,135,16,13479
2021-09-19,9,9593,137,2919,660,274,6,13589
2021-09-19,10,9594,169,3333,539,374,26,14035
2021-09-19,11,9590,155,3218,552,414,25,13954
2021-09-19,12,9581,151,3353,637,419,14,14155
2021-09-19,13,9580,244,3590,709,410,14,14547
2021-09-19,14,9573,430,3599,709,409,7,14727
2021-09-19,15,9574,660,3943,728,375,0,15280
2021-09-19,16,9573,900,4097,734,299,0,15603
2021-09-19,17,9567,1142,4171,669,176,2,15727
2021-09-19,18,9578,1115,4236,679,51,7,15666
2021-09-19,19,9584,769,4027,910,0,10,15300
2021-09-19,20,9586,743,3708,1303,0,0,15340
2021-09-19,21,9591,749,3113,1285,0,0,14738
2021-09-19,22,9594,252,2829,1332,0,0,14007
2021-09-19,23,9600,144,2653,1236,0,0,13633
2021-09-19,24,9609,143,2458,1340,0,0,13550
2021-09-20,1,9599,142,2361,1638,0,0,13740
2021-09-20,2,9616,146,2347,1657,0,9,13775
2021-09-20,3,9616,162,2383,1577,0,11,13749
2021-09-20,4,9627,178,2446,1567,0,15,13833
2021-09-20,5,9610,292,2360,1546,0,19,13827
2021-09-20,6,9584,460,2535,1574,3,30,14186
2021-09-20,7,9588,674,3135,1616,19,32,15064
2021-09-20,8,9573,785,3440,1433,121,33,15385
2021-09-20,9,9560,1131,3643,1002,229,33,15598
2021-09-20,10,9559,1847,3983,761,271,33,16454
2021-09-20,11,9555,1940,3805,638,309,33,16280
2021-09-20,12,9564,1976,3715,717,349,32,16353
2021-09-20,13,9570,1722,3542,885,366,33,16118
2021-09-20,14,9570,1806,3515,825,288,34,16038
2021-09-20,15,9569,1897,3551,1030,223,32,16302
2021-09-20,16,9580,2026,4170,1141,153,32,17102
2021-09-20,17,9587,2227,4285,1223,103,32,17457
2021-09-20,18,9603,2023,4058,1309,26,33,17052
2021-09-20,19,9609,2010,3613,1820,0,33,17085
2021-09-20,20,9599,1507,3352,2105,0,33,16596
2021-09-20,21,9595,1021,3200,2147,0,31,15994
2021-09-20,22,9584,274,3007,2520,0,32,15417
2021-09-20,23,9602,141,2479,2740,0,17,14979
2021-09-20,24,9569,138,2495,2484,0,13,14699
2021-09-21,1,9532,139,2422,2769,0,14,14876
2021-09-21,2,9545,139,2464,2856,0,14,15018
2021-09-21,3,9539,139,2356,2968,0,15,15017
2021-09-21,4,9544,139,2342,3108,0,15,15148
2021-09-21,5,9563,139,2347,2990,0,16,15055
2021-09-21,6,9586,144,2374,3318,1,29,15452
2021-09-21,7,9579,184,2653,3462,6,31,15915
2021-09-21,8,9568,278,2702,3592,44,32,16216
2021-09-21,9,9565,428,2827,3689,103,32,16644
2021-09-21,10,9573,895,2827,3635,188,37,17155
2021-09-21,11,9579,1345,2805,3678,236,38,17681
2021-09-21,12,9574,1395,3354,3568,197,33,18121
2021-09-21,13,9573,1706,3771,3290,149,36,18525
2021-09-21,14,9576,1868,3935,2853,109,33,18374
2021-09-21,15,9579,2080,3786,2340,91,32,17908
2021-09-21,16,9584,2013,3827,2212,93,32,17761
2021-09-21,17,9582,1973,4015,1959,68,31,17628
2021-09-21,18,9582,1974,3890,1946,11,31,17434
2021-09-21,19,9578,2004,3864,1917,0,31,17394
2021-09-21,20,9579,1675,3747,1719,0,34,16754
2021-09-21,21,9569,1611,3230,2050,0,31,16491
2021-09-21,22,9548,1182,2741,2129,0,31,15631
2021-09-21,23,9560,777,2598,2219,0,18,15172
2021-09-21,24,9556,399,2643,2173,0,15,14786
2021-09-22,1,9560,177,2433,2672,0,15,14857
2021-09-22,2,9567,142,2436,2786,0,15,14946
2021-09-22,3,9579,142,2372,2813,0,17,14923
2021-09-22,4,9581,148,2529,2556,0,17,14831
2021-09-22,5,9576,154,2510,2494,0,18,14752
2021-09-22,6,9581,208,2702,2415,1,27,14934
2021-09-22,7,9570,366,2944,2505,2,32,15419
2021-09-22,8,9567,392,2989,2783,13,34,15778
2021-09-22,9,9571,448,3095,2715,34,34,15897
2021-09-22,10,9586,591,3241,2811,45,39,16313
2021-09-22,11,9596,590,3166,3013,55,43,16463
2021-09-22,12,9600,592,3331,2966,58,44,16591
2021-09-22,13,9602,591,3451,2829,60,47,16580
2021-09-22,14,9612,589,3204,2774,60,46,16285
2021-09-22,15,9622,587,3221,2764,56,41,16291
2021-09-22,16,9627,588,3313,2924,31,34,16517
2021-09-22,17,9633,589,3461,3113,16,36,16848
2021-09-22,18,9636,589,3490,3364,6,31,17116
2021-09-22,19,9649,588,3586,3306,0,31,17160
2021-09-22,20,9662,557,3337,3146,0,31,16733
2021-09-22,21,9669,552,3012,3174,0,30,16437
2021-09-22,22,9673,228,3038,3185,0,30,16154
2021-09-22,23,9675,151,2743,2883,0,23,15475
2021-09-22,24,9684,148,2733,2451,0,17,15033
2021-09-23,1,9689,147,2712,2043,0,16,14607
2021-09-23,2,9686,147,2807,2091,0,16,14747
2021-09-23,3,9687,147,2777,2162,0,16,14789
2021-09-23,4,9693,154,2796,2007,0,16,14666
2021-09-23,5,9690,155,2686,1876,0,18,14425
2021-09-23,6,9701,194,2711,2099,3,27,14735
2021-09-23,7,9701,364,2960,2376,3,47,15451
2021-09-23,8,9693,365,2983,2626,20,53,15740
2021-09-23,9,9684,374,3350,2656,76,46,16186
2021-09-23,10,9699,374,3524,2702,77,44,16420
2021-09-23,11,9715,412,3404,2705,100,48,16384
2021-09-23,12,9721,559,3454,2654,106,42,16536
2021-09-23,13,9715,558,3518,2724,96,36,16647
2021-09-23,14,9705,555,3236,2603,79,36,16214
2021-09-23,15,9703,554,3321,2377,80,31,16066
2021-09-23,16,9710,553,3586,2490,43,32,16414
2021-09-23,17,9712,552,3731,2288,24,32,16339
2021-09-23,18,9716,553,3650,2323,8,31,16281
2021-09-23,19,9719,615,4087,2166,0,31,16618
2021-09-23,20,9707,658,3995,2214,0,31,16605
2021-09-23,21,9711,554,3266,2225,0,21,15777
2021-09-23,22,9703,230,3254,2359,0,29,15575
2021-09-23,23,9711,175,2741,2380,0,23,15030
2021-09-23,24,9713,175,2633,2059,0,17,14597
2021-09-24,1,9717,175,2634,2198,0,16,14740
2021-09-24,2,9734,175,2653,2235,0,16,14813
2021-09-24,3,9737,175,2603,2122,0,16,14653
2021-09-24,4,9731,175,2818,1889,0,17,14630
2021-09-24,5,9756,174,2814,1551,0,19,14314
2021-09-24,6,9767,175,2776,1849,1,26,14594
2021-09-24,7,9761,183,3178,2087,6,31,15246
2021-09-24,8,9764,220,3359,2242,63,33,15681
2021-09-24,9,9767,173,3449,2166,136,31,15722
2021-09-24,10,9757,203,3478,2112,226,31,15807
2021-09-24,11,9755,212,3528,2268,181,0,15944
2021-09-24,12,9759,232,3663,2303,206,31,16194
2021-09-24,13,9758,290,3653,1970,305,31,16007
2021-09-24,14,9754,441,3756,1922,299,32,16204
2021-09-24,15,9762,601,3628,2277,236,31,16535
2021-09-24,16,9769,631,3895,1987,162,31,16475
2021-09-24,17,9776,656,4247,1573,92,32,16376
2021-09-24,18,9785,640,4274,1219,31,32,15981
2021-09-24,19,9799,693,4155,1181,0,32,15860
2021-09-24,20,9805,607,4018,1389,0,33,15852
2021-09-24,21,9818,470,3807,1666,0,33,15794
2021-09-24,22,9821,280,3128,1959,0,32,15220
2021-09-24,23,9821,221,2963,1900,0,24,14929
2021-09-24,24,9819,207,3003,1793,0,15,14837
2021-09-25,1,9818,207,2913,1725,0,11,14674
2021-09-25,2,9808,207,2808,1553,0,4,14380
2021-09-25,3,9807,207,2852,1279,0,0,14145
2021-09-25,4,9802,207,2913,1145,0,0,14067
2021-09-25,5,9785,207,2940,1344,0,0,14276
2021-09-25,6,9777,207,2951,1746,2,0,14683
2021-09-25,7,9771,235,2999,2029,11,0,15045
2021-09-25,8,9757,238,2920,2236,89,0,15240
2021-09-25,9,9764,238,3367,2052,156,0,15577
2021-09-25,10,9763,238,3385,1918,250,0,15554
2021-09-25,11,9756,237,3520,1808,280,0,15601
2021-09-25,12,9755,267,3604,1912,264,0,15802
2021-09-25,13,9752,300,3628,1933,286,0,15899
2021-09-25,14,9761,431,3751,2042,215,0,16200
2021-09-25,15,9779,477,3517,2117,185,0,16075
2021-09-25,16,9769,614,3745,1587,142,0,15857
2021-09-25,17,9755,655,4432,1165,86,0,16093
2021-09-25,18,9770,807,4215,978,29,0,15799
2021-09-25,19,9782,658,4184,945,0,0,15569
2021-09-25,20,9783,612,3677,965,0,0,15037
2021-09-25,21,9786,612,3410,1366,0,0,15174
2021-09-25,22,9791,291,3219,1693,0,0,14994
2021-09-25,23,9794,211,3109,1808,0,0,14922
2021-09-25,24,9801,209,2988,1404,0,0,14402
2021-09-26,1,9819,209,2881,1200,0,0,14109
2021-09-26,2,9833,208,2728,1229,0,0,13998
2021-09-26,3,9856,208,2737,1074,0,0,13875
2021-09-26,4,9852,208,2794,814,0,0,13668
2021-09-26,5,9382,235,2822,515,0,0,12954
2021-09-26,6,9346,240,3035,965,2,0,13588
2021-09-26,7,9480,238,3032,1195,17,0,13962
2021-09-26,8,9812,237,3115,1167,120,0,14451
2021-09-26,9,9857,236,3491,886,236,0,14706
2021-09-26,10,9855,236,3275,970,337,0,14673
2021-09-26,11,9855,236,3300,1001,371,0,14763
2021-09-26,12,9846,238,3160,1098,353,0,14695
2021-09-26,13,9837,253,3763,1085,306,0,15244
2021-09-26,14,9832,281,3934,1253,182,0,15482
2021-09-26,15,9825,316,3738,1282,206,0,15367
2021-09-26,16,9821,442,3598,1140,170,0,15171
2021-09-26,17,9849,452,4274,1087,64,0,15726
2021-09-26,18,9883,490,4081,1255,19,0,15728
2021-09-26,19,9898,461,3494,1413,1,0,15267
2021-09-26,20,9908,460,3509,994,1,0,14872
2021-09-26,21,9916,460,3231,1417,0,0,15024
2021-09-26,22,9912,297,2901,1673,0,0,14783
2021-09-26,23,9922,258,2595,1998,0,0,14773
2021-09-26,24,9919,259,2582,1536,0,0,14296
2021-09-27,1,9922,259,2576,1212,0,0,13969
2021-09-27,2,9929,258,2501,1037,0,0,13725
2021-09-27,3,9909,264,2473,843,0,9,13498
2021-09-27,4,9920,261,2471,892,0,10,13554
2021-09-27,5,9923,288,2605,1206,0,17,14039
2021-09-27,6,9909,311,2614,2343,1,25,15203
2021-09-27,7,9903,348,3167,2872,3,31,16324
2021-09-27,8,9894,352,3365,2905,39,31,16586
2021-09-27,9,9888,396,3436,2842,126,32,16720
2021-09-27,10,9882,498,3396,2802,197,31,16806
2021-09-27,11,9903,583,3353,2408,240,31,16518
2021-09-27,12,9912,730,3578,1784,257,32,16293
2021-09-27,13,9924,1176,3768,1385,310,29,16592
2021-09-27,14,9935,1338,3769,1321,304,28,16695
2021-09-27,15,9940,1244,4070,1209,210,36,16709
2021-09-27,16,9941,1493,4236,968,137,40,16815
2021-09-27,17,9935,1684,4427,701,91,31,16869
2021-09-27,18,9945,1939,4438,570,24,31,16947
2021-09-27,19,9952,1573,4247,617,0,31,16420
2021-09-27,20,9952,1502,3809,857,0,31,16151
2021-09-27,21,9957,1479,3479,928,0,31,15874
2021-09-27,22,9958,1282,3193,1051,0,32,15516
2021-09-27,23,9962,564,3267,1132,0,21,14946
2021-09-27,24,9958,430,3175,978,0,18,14559
2021-09-28,1,9955,262,3066,957,0,19,14259
2021-09-28,2,9944,269,3151,963,0,17,14344
2021-09-28,3,9937,270,3082,918,0,17,14224
2021-09-28,4,9940,257,2964,1075,0,18,14254
2021-09-28,5,9939,239,2732,1066,0,21,13997
2021-09-28,6,9938,343,2788,1274,1,27,14371
2021-09-28,7,9945,640,3098,1263,6,32,14984
2021-09-28,8,9944,630,3481,1018,114,33,15220
2021-09-28,9,9940,801,3602,567,264,38,15212
2021-09-28,10,9953,654,3310,495,364,8,14784
2021-09-28,11,9957,623,3289,563,387,32,14851
2021-09-28,12,9956,626,3371,361,400,32,14746
2021-09-28,13,9954,559,3416,381,412,31,14753
2021-09-28,14,9945,557,3586,473,386,31,14978
2021-09-28,15,9931,704,3639,558,375,32,15239
2021-09-28,16,9922,851,3964,482,278,32,15529
2021-09-28,17,9915,1025,4184,569,144,32,15869
2021-09-28,18,9912,926,4329,598,30,32,15827
2021-09-28,19,9909,1089,4329,602,0,32,15961
2021-09-28,20,9910,1124,4081,532,0,32,15679
2021-09-28,21,9900,1080,3909,535,0,31,15455
2021-09-28,22,9900,654,3510,540,0,31,14635
2021-09-28,23,9906,317,3352,622,0,21,14218
2021-09-28,24,9908,247,3203,654,0,17,14029
2021-09-29,1,9928,295,3304,573,0,17,14117
2021-09-29,2,9938,350,3395,486,0,17,14186
2021-09-29,3,9936,470,3269,431,0,17,14123
2021-09-29,4,9947,596,3220,399,0,17,14179
2021-09-29,5,9945,702,3037,330,0,17,14031
2021-09-29,6,9936,903,3532,280,1,24,14676
2021-09-29,7,9928,1094,4122,287,8,34,15473
2021-09-29,8,9919,1320,4012,224,91,34,15600
2021-09-29,9,9913,1402,3617,70,173,33,15208
2021-09-29,10,9913,1121,3499,47,256,32,14868
2021-09-29,11,9908,1166,3614,160,320,32,15200
2021-09-29,12,9911,1361,3664,229,329,31,15525
2021-09-29,13,9913,1654,3837,179,230,31,15844
2021-09-29,14,9911,1466,3915,406,264,33,15995
2021-09-29,15,9908,1526,3739,472,218,31,15894
2021-09-29,16,9911,1791,3771,510,172,31,16186
2021-09-29,17,9913,1922,3988,484,102,32,16441
2021-09-29,18,9915,1920,4143,454,22,32,16486
2021-09-29,19,9912,1932,3999,544,0,31,16418
2021-09-29,20,9923,1765,3889,765,0,31,16373
2021-09-29,21,9926,1187,3618,785,0,31,15547
2021-09-29,22,9933,439,3403,823,0,31,14629
2021-09-29,23,9937,243,3281,746,0,23,14230
2021-09-29,24,9939,223,3071,735,0,20,13988
2021-09-30,1,9936,223,2912,746,0,15,13832
2021-09-30,2,9933,223,2713,704,0,15,13588
2021-09-30,3,9923,233,2676,621,0,16,13469
2021-09-30,4,9920,358,2775,502,0,18,13573
2021-09-30,5,9916,544,2605,307,0,22,13394
2021-09-30,6,9913,796,3062,273,1,26,14071
2021-09-30,7,9913,1106,3739,281,8,31,15078
2021-09-30,8,9915,1059,3627,253,72,31,14957
2021-09-30,9,9913,1156,3615,122,143,31,14980
2021-09-30,10,9906,1413,3771,75,212,31,15408
2021-09-30,11,9896,1922,3704,60,240,31,15853
2021-09-30,12,9893,1762,3468,45,210,31,15409
2021-09-30,13,9903,1758,3574,64,225,31,15555
2021-09-30,14,9904,1826,3409,116,195,31,15481
2021-09-30,15,9897,1928,3689,150,133,31,15828
2021-09-30,16,9896,1994,3870,158,76,31,16025
2021-09-30,17,9894,1794,4014,142,78,31,15953
2021-09-30,18,9518,1903,4086,90,23,31,15651
2021-09-30,19,9381,2266,4265,126,1,31,16070
2021-09-30,20,9376,1884,4003,208,0,31,15502
2021-09-30,21,9371,1605,3767,364,0,31,15138
2021-09-30,22,9232,1360,3534,302,0,31,14459
2021-09-30,23,8685,747,3498,452,0,21,13403
2021-09-30,24,8556,482,3181,390,0,16,12625
2021-10-01,1,8484,274,3710,381,0,15,12864
2021-10-01,2,8480,262,3372,337,0,16,12467
2021-10-01,3,8482,442,3362,265,0,15,12566
2021-10-01,4,8482,718,3358,212,0,17,12787
2021-10-01,5,8487,890,3071,204,0,21,12673
2021-10-01,6,8493,1221,3351,188,1,26,13280
2021-10-01,7,8494,1768,3833,146,10,32,14283
2021-10-01,8,8400,1829,3995,148,103,32,14507
2021-10-01,9,8394,1639,4044,121,210,32,14440
2021-10-01,10,8390,1476,3946,98,315,31,14256
2021-10-01,11,8389,1445,3841,149,333,31,14188
2021-10-01,12,8399,1439,3689,334,327,32,14220
2021-10-01,13,8439,1687,3399,452,347,33,14357
2021-10-01,14,8433,1808,3366,486,364,31,14488
2021-10-01,15,8428,1940,3404,422,325,31,14550
2021-10-01,16,8455,2013,3942,471,235,31,15147
2021-10-01,17,8434,2009,4067,519,113,37,15179
2021-10-01,18,8468,1992,4058,546,22,31,15117
2021-10-01,19,8469,1991,3957,785,0,31,15233
2021-10-01,20,8474,1987,3774,1009,0,31,15275
2021-10-01,21,8471,1478,3465,1193,0,31,14638
2021-10-01,22,8474,769,3099,1501,0,31,13874
2021-10-01,23,8478,308,3008,1747,0,19,13560
2021-10-01,24,8478,216,2927,1766,0,5,13392
2021-10-02,1,8478,214,2722,1661,0,4,13079
2021-10-02,2,8473,214,2690,1956,0,0,13333
2021-10-02,3,8473,221,2671,2105,0,0,13470
2021-10-02,4,8477,230,3008,2043,0,0,13758
2021-10-02,5,8475,283,3216,1841,0,0,13815
2021-10-02,6,8470,578,3296,1716,2,0,14062
2021-10-02,7,8468,784,3188,1755,2,0,14197
2021-10-02,8,8471,950,3353,1495,56,0,14325
2021-10-02,9,8472,1172,3727,1065,124,0,14560
2021-10-02,10,8480,1429,3863,851,196,0,14819
2021-10-02,11,8486,1419,3952,806,243,0,14906
2021-10-02,12,8491,1510,3945,844,257,0,15047
2021-10-02,13,8494,1662,3894,934,235,0,15219
2021-10-02,14,8492,1540,3758,970,228,0,14988
2021-10-02,15,8495,1469,3712,1107,151,0,14934
2021-10-02,16,8494,1521,3841,1222,91,0,15169
2021-10-02,17,8486,1873,4125,1219,65,0,15768
2021-10-02,18,8485,1994,4018,1279,10,0,15786
2021-10-02,19,8482,1789,3999,1611,0,0,15881
2021-10-02,20,8483,1374,3706,1752,0,0,15315
2021-10-02,21,8478,788,3525,1892,0,0,14683
2021-10-02,22,8472,472,3298,1945,0,0,14187
2021-10-02,23,8472,233,2994,2032,0,1,13732
2021-10-02,24,8469,154,3255,1830,0,0,13708
2021-10-03,1,8473,246,3326,1603,0,0,13648
2021-10-03,2,8479,313,3418,1226,0,0,13436
2021-10-03,3,8480,276,3458,950,0,0,13164
2021-10-03,4,8484,290,3390,813,0,0,12977
2021-10-03,5,8491,352,3276,722,0,0,12841
2021-10-03,6,8492,594,3382,604,2,0,13074
2021-10-03,7,8491,1092,3486,442,3,0,13514
2021-10-03,8,8489,1431,3735,466,13,0,14134
2021-10-03,9,8486,1637,3743,518,38,0,14422
2021-10-03,10,8490,1831,3785,604,47,0,14757
2021-10-03,11,8503,2024,3874,647,86,0,15134
2021-10-03,12,8503,2402,3896,584,77,0,15462
2021-10-03,13,8497,2490,3563,562,99,0,15211
2021-10-03,14,8470,2555,3592,565,97,0,15279
2021-10-03,15,8368,2615,3993,499,101,0,15576
2021-10-03,16,8372,3033,4116,380,73,0,15974
2021-10-03,17,8373,3237,4281,422,34,0,16347
2021-10-03,18,8370,3051,4265,416,8,0,16110
2021-10-03,19,8366,2953,4293,495,0,0,16107
2021-10-03,20,8372,2746,4201,530,0,0,15849
2021-10-03,21,8380,2390,3986,525,0,0,15281
2021-10-03,22,8384,1995,3436,668,0,0,14483
2021-10-03,23,8390,1454,2919,719,0,0,13482
2021-10-03,24,8390,1042,2836,604,0,0,12872
2021-10-04,1,8394,991,3084,608,0,0,13077
2021-10-04,2,8392,1027,3204,648,0,0,13271
2021-10-04,3,8390,1263,3256,715,0,12,13636
2021-10-04,4,8383,1508,3032,771,0,18,13712
2021-10-04,5,8388,1916,2717,578,0,22,13621
2021-10-04,6,8387,2443,2786,559,0,28,14203
2021-10-04,7,8382,2766,3358,733,2,33,15274
2021-10-04,8,8372,3003,3764,672,17,33,15861
2021-10-04,9,8367,3149,3913,602,39,32,16102
2021-10-04,10,8362,3120,3975,527,63,33,16080
2021-10-04,11,8357,3626,3875,375,91,33,16357
2021-10-04,12,8354,3603,3952,230,113,35,16287
2021-10-04,13,8360,3354,4006,227,116,35,16098
2021-10-04,14,8363,2725,4082,280,138,33,15621
2021-10-04,15,8366,2632,4310,375,96,32,15811
2021-10-04,16,8371,2816,4382,510,59,32,16170
2021-10-04,17,8376,2401,4513,602,29,33,15954
2021-10-04,18,8380,2513,4451,572,6,33,15955
2021-10-04,19,8377,2717,4410,586,0,55,16145
2021-10-04,20,8378,2714,4309,607,0,55,16063
2021-10-04,21,8379,2670,4097,590,0,40,15776
2021-10-04,22,8360,2051,3790,543,0,40,14784
2021-10-04,23,8376,1759,3406,430,0,30,14001
2021-10-04,24,8376,1611,2863,339,0,37,13226
2021-10-05,1,8371,1199,3216,457,0,37,13280
2021-10-05,2,8375,1218,3372,415,0,38,13418
2021-10-05,3,8375,1279,3330,343,0,39,13366
2021-10-05,4,8369,1508,3389,297,0,37,13600
2021-10-05,5,8376,1763,3035,269,0,34,13477
2021-10-05,6,8372,2154,3030,281,1,33,13871
2021-10-05,7,8370,2833,3870,366,2,34,15475
2021-10-05,8,8373,3487,3937,314,29,34,16174
2021-10-05,9,8369,3381,3991,259,75,38,16113
2021-10-05,10,8367,3210,3951,245,107,40,15920
2021-10-05,11,8369,3134,4003,196,150,34,15886
2021-10-05,12,8366,2973,4141,156,196,39,15871
2021-10-05,13,8360,3108,4087,109,181,37,15882
2021-10-05,14,8354,3340,3996,127,151,46,16014
2021-10-05,15,8350,3010,4100,149,133,51,15793
2021-10-05,16,8349,3187,4290,168,105,46,16145
2021-10-05,17,8351,3242,4557,218,53,49,16470
2021-10-05,18,8356,3899,4654,197,10,52,17168
2021-10-05,19,8354,3771,4461,229,0,46,16861
2021-10-05,20,8348,3473,4218,297,0,48,16384
2021-10-05,21,8352,2679,4102,361,0,35,15529
2021-10-05,22,8339,2344,3611,391,0,33,14718
2021-10-05,23,8357,1645,3336,392,0,22,13752
2021-10-05,24,8359,1477,3165,366,0,16,13383
2021-10-06,1,8361,1417,3149,399,0,16,13342
2021-10-06,2,8363,1395,3285,383,0,16,13442
2021-10-06,3,8367,1421,3263,348,0,16,13415
2021-10-06,4,8372,1563,3354,324,0,15,13628
2021-10-06,5,8371,1804,3120,368,0,18,13681
2021-10-06,6,8363,2393,3027,457,1,27,14268
2021-10-06,7,8365,2894,3745,473,7,31,15515
2021-10-06,8,8363,3187,3742,499,51,32,15874
2021-10-06,9,8363,3018,3776,489,130,32,15808
2021-10-06,10,8362,2856,3801,433,218,31,15701
2021-10-06,11,8350,2724,3895,359,253,31,15612
2021-10-06,12,8351,2654,3990,349,257,35,15636
2021-10-06,13,8345,2688,3944,352,259,33,15621
2021-10-06,14,8342,2715,3979,352,306,31,15725
2021-10-06,15,8338,2712,3896,337,272,31,15586
2021-10-06,16,8338,2953,4007,322,209,31,15860
2021-10-06,17,8341,3546,4439,281,106,33,16746
2021-10-06,18,8275,3306,4453,290,13,34,16371
2021-10-06,19,8261,3508,4478,353,1,33,16634
2021-10-06,20,8263,3557,4298,368,0,33,16519
2021-10-06,21,8265,3260,4037,371,0,33,15966
2021-10-06,22,8271,2464,3695,420,0,33,14883
2021-10-06,23,8272,1648,3552,437,0,25,13934
2021-10-06,24,8276,1489,3546,477,0,22,13810
2021-10-07,1,8272,1183,3192,496,0,33,13176
2021-10-07,2,8274,1123,3119,468,0,49,13033
2021-10-07,3,8279,1295,3200,451,0,44,13269
2021-10-07,4,8279,1425,3254,385,0,37,13380
2021-10-07,5,8280,1625,3319,331,0,41,13596
2021-10-07,6,8275,2045,3506,307,1,56,14190
2021-10-07,7,8269,2762,3823,301,2,61,15218
2021-10-07,8,8262,3307,3799,312,16,59,15755
2021-10-07,9,8263,3229,3731,317,64,62,15666
2021-10-07,10,8263,3269,3824,263,150,62,15831
2021-10-07,11,8261,2879,3768,244,209,55,15416
2021-10-07,12,8263,2729,3967,200,302,53,15514
2021-10-07,13,8262,2442,4094,167,305,49,15319
2021-10-07,14,8259,2781,4087,115,257,56,15555
2021-10-07,15,8265,3474,4143,101,216,58,16257
2021-10-07,16,8244,3372,4385,93,147,59,16300
2021-10-07,17,8250,3807,4491,89,68,61,16766
2021-10-07,18,8263,3613,4416,142,6,62,16502
2021-10-07,19,8262,3607,4371,277,0,59,16576
2021-10-07,20,8260,3718,4367,296,0,54,16695
2021-10-07,21,8257,3345,4168,385,0,44,16199
2021-10-07,22,8243,2779,3927,400,0,37,15386
2021-10-07,23,8256,1955,3578,443,0,31,14263
2021-10-07,24,8257,1485,3349,406,0,38,13535
2021-10-08,1,8259,1180,3233,343,0,44,13059
2021-10-08,2,8263,1102,3289,418,0,41,13113
2021-10-08,3,8260,1122,3094,399,0,41,12916
2021-10-08,4,8262,1405,3357,338,0,40,13402
2021-10-08,5,8247,1657,3067,367,0,42,13380
2021-10-08,6,8241,2157,3339,478,1,44,14260
2021-10-08,7,8246,2778,3694,510,7,36,15271
2021-10-08,8,8240,3037,3705,608,67,32,15689
2021-10-08,9,8237,3035,3818,598,140,31,15859
2021-10-08,10,8245,3206,3770,594,190,32,16037
2021-10-08,11,8250,3343,3971,527,233,36,16360
2021-10-08,12,8254,3060,4180,528,245,31,16298
2021-10-08,13,8251,3183,3997,495,271,31,16228
2021-10-08,14,8253,3071,4050,439,292,31,16136
2021-10-08,15,8243,3203,4213,403,224,31,16317
2021-10-08,16,8246,3153,4216,356,192,31,16194
2021-10-08,17,8246,3029,4407,403,94,31,16210
2021-10-08,18,8254,2823,4438,534,9,31,16089
2021-10-08,19,8248,2963,4437,795,0,31,16474
2021-10-08,20,8245,2890,4287,1027,0,31,16480
2021-10-08,21,8236,2504,4049,1038,0,31,15858
2021-10-08,22,8237,1842,3926,1094,0,31,15130
2021-10-08,23,7894,1452,3674,1051,0,16,14087
2021-10-08,24,7728,1125,3471,904,0,5,13233
2021-10-09,1,7734,622,3355,847,0,0,12558
2021-10-09,2,7736,182,3255,728,0,0,11901
2021-10-09,3,7741,176,3285,569,0,0,11771
2021-10-09,4,7740,190,3327,576,0,0,11833
2021-10-09,5,7743,341,3076,632,0,0,11792
2021-10-09,6,7733,821,3119,540,1,0,12214
2021-10-09,7,7730,1387,3342,556,2,0,13017
2021-10-09,8,7727,2023,3748,574,38,0,14110
2021-10-09,9,7724,2673,3880,676,82,0,15035
2021-10-09,10,7721,2911,3927,726,113,0,15398
2021-10-09,11,7722,2962,3975,757,125,0,15541
2021-10-09,12,7792,3057,4039,743,129,0,15760
2021-10-09,13,7938,2965,4064,691,148,0,15806
2021-10-09,14,7941,2668,4023,635,154,0,15421
2021-10-09,15,7940,2846,3981,718,116,0,15601
2021-10-09,16,7940,2572,4283,753,68,0,15616
2021-10-09,17,7941,2910,4365,691,28,0,15935
2021-10-09,18,7948,2490,4233,633,5,0,15309
2021-10-09,19,7946,2638,4173,964,0,0,15721
2021-10-09,20,7919,1821,3942,1317,0,0,14999
2021-10-09,21,7892,1421,3475,1621,0,0,14409
2021-10-09,22,7893,816,3261,1722,0,0,13692
2021-10-09,23,7895,179,3032,1972,0,0,13078
2021-10-09,24,7891,131,2844,1967,0,0,12833
2021-10-10,1,7905,130,2872,2101,0,0,13008
2021-10-10,2,7909,139,3216,2095,0,0,13359
2021-10-10,3,7909,132,3144,2160,0,0,13345
2021-10-10,4,7910,138,3193,2222,0,0,13463
2021-10-10,5,7907,139,3099,2185,0,0,13330
2021-10-10,6,7904,161,3415,2213,1,0,13694
2021-10-10,7,7896,132,3215,2311,3,0,13557
2021-10-10,8,7890,137,3087,2388,24,0,13526
2021-10-10,9,7890,271,3871,2391,53,0,14476
2021-10-10,10,7893,637,4280,2334,97,0,15241
2021-10-10,11,7882,1047,4162,2229,133,0,15453
2021-10-10,12,7892,1209,4388,2031,94,3,15617
2021-10-10,13,7859,1139,4247,2035,115,10,15405
2021-10-10,14,7859,1180,3621,2182,217,5,15064
2021-10-10,15,7857,1370,3441,1967,233,13,14881
2021-10-10,16,7809,1567,3587,2162,122,2,15249
2021-10-10,17,7914,1562,3966,2514,36,0,15992
2021-10-10,18,7936,1404,3736,2328,6,0,15410
2021-10-10,19,7937,1376,3688,2347,0,0,15348
2021-10-10,20,7941,1218,3181,2722,0,1,15063
2021-10-10,21,7939,581,3190,2756,0,1,14467
2021-10-10,22,7941,214,3242,3067,0,1,14465
2021-10-10,23,7945,144,3410,2821,0,1,14321
2021-10-10,24,7942,137,3195,2804,0,0,14078
2021-10-11,1,7939,132,2815,2729,0,0,13615
2021-10-11,2,7937,132,2863,2590,0,0,13522
2021-10-11,3,7938,132,2636,2468,0,0,13174
2021-10-11,4,7941,133,2760,2562,0,0,13396
2021-10-11,5,7944,132,2657,2403,0,0,13136
2021-10-11,6,7939,132,2713,2383,2,0,13169
2021-10-11,7,7935,132,2676,2562,2,0,13307
2021-10-11,8,7929,134,2817,2269,49,0,13198
2021-10-11,9,7928,236,3085,2268,134,0,13651
2021-10-11,10,7922,618,3118,2040,253,0,13951
2021-10-11,11,7915,955,3029,1782,309,0,13990
2021-10-11,12,7975,1422,3378,1913,344,0,15032
2021-10-11,13,8070,1314,3189,1937,358,0,14868
2021-10-11,14,8114,1345,3168,2019,334,0,14980
2021-10-11,15,8105,1528,3412,1995,254,0,15294
2021-10-11,16,8111,1908,3593,2227,137,0,15976
2021-10-11,17,8122,2053,3826,2184,48,0,16233
2021-10-11,18,8282,1853,3928,2218,7,0,16288
2021-10-11,19,8302,1801,3929,2541,0,0,16573
2021-10-11,20,8294,1455,3690,2798,0,0,16237
2021-10-11,21,8292,958,3559,2502,0,0,15311
2021-10-11,22,8300,210,3592,2591,0,0,14693
2021-10-11,23,8314,132,3528,2496,0,0,14470
2021-10-11,24,8317,132,3361,2318,0,0,14128
2021-10-12,1,8323,136,2829,2281,0,5,13574
2021-10-12,2,8322,139,2838,2209,0,10,13518
2021-10-12,3,8320,224,2783,2162,0,14,13503
2021-10-12,4,8326,276,2849,2089,0,15,13555
2021-10-12,5,8325,392,2854,1880,0,16,13467
2021-10-12,6,8328,648,3062,2256,2,22,14318
2021-10-12,7,8388,1097,3277,2723,3,31,15519
2021-10-12,8,8380,1518,3279,2542,74,31,15824
2021-10-12,9,8372,2048,3349,1962,167,31,15929
2021-10-12,10,8372,2166,3459,2580,229,31,16837
2021-10-12,11,8373,2346,3584,2516,247,31,17097
2021-10-12,12,8373,2367,3469,2215,204,32,16660
2021-10-12,13,8369,2319,3613,2027,213,32,16573
2021-10-12,14,8375,2376,3710,2111,211,31,16814
2021-10-12,15,8398,2558,3855,1771,230,31,16843
2021-10-12,16,8427,2437,4055,2221,122,31,17293
2021-10-12,17,8437,2942,4322,2036,53,30,17820
2021-10-12,18,8434,3324,4198,1660,2,30,17648
2021-10-12,19,8430,3145,4352,1560,0,30,17517
2021-10-12,20,8427,2879,4184,1491,0,30,17011
2021-10-12,21,8429,2352,4068,1552,0,31,16432
2021-10-12,22,8426,1740,3770,1381,0,31,15348
2021-10-12,23,8428,1056,3637,1273,0,22,14416
2021-10-12,24,8433,919,3480,1224,0,17,14073
2021-10-13,1,8436,604,3210,1111,0,16,13377
2021-10-13,2,8431,706,3219,973,0,16,13345
2021-10-13,3,8426,879,3258,800,0,17,13380
2021-10-13,4,8429,945,3143,601,0,23,13141
2021-10-13,5,8423,1246,3080,501,0,39,13289
2021-10-13,6,8424,1849,3303,374,0,51,14001
2021-10-13,7,8420,2519,3671,477,2,50,15139
2021-10-13,8,8414,3332,3620,419,10,41,15836
2021-10-13,9,8403,3474,3762,290,58,49,16036
2021-10-13,10,8400,3569,3552,282,111,54,15968
2021-10-13,11,8403,3461,3540,347,110,55,15916
2021-10-13,12,8403,3325,3348,603,148,55,15882
2021-10-13,13,8405,3506,3265,737,139,56,16108
2021-10-13,14,8408,3537,3603,805,154,54,16561
2021-10-13,15,8407,3553,3727,656,130,51,16524
2021-10-13,16,8416,3735,3714,524,123,45,16557
2021-10-13,17,8414,3964,3955,376,57,44,16810
2021-10-13,18,8421,4188,3881,305,4,39,16838
2021-10-13,19,8420,3448,4126,389,0,35,16418
2021-10-13,20,8415,2935,4458,560,0,33,16401
2021-10-13,21,8412,2881,4062,778,0,32,16165
2021-10-13,22,8413,1798,3837,980,0,33,15061
2021-10-13,23,8417,1208,3624,1059,0,26,14334
2021-10-13,24,8419,977,3529,938,0,18,13881
2021-10-14,1,8424,635,3655,978,0,17,13709
2021-10-14,2,8425,629,3574,920,0,17,13565
2021-10-14,3,8426,733,3610,894,0,17,13680
2021-10-14,4,8456,724,3593,830,0,18,13621
2021-10-14,5,8467,1025,3429,780,0,20,13721
2021-10-14,6,8453,1642,3304,830,2,29,14260
2021-10-14,7,8452,2190,3583,994,2,31,15252
2021-10-14,8,8445,2290,3594,1033,41,36,15439
2021-10-14,9,8444,2309,3821,826,100,38,15538
2021-10-14,10,8445,2820,3648,665,200,47,15825
2021-10-14,11,8447,3145,3901,604,218,47,16362
2021-10-14,12,8457,3128,3819,551,226,43,16224
2021-10-14,13,8455,3037,3874,457,202,38,16063
2021-10-14,14,8447,3363,4036,545,229,31,16651
2021-10-14,15,8446,3268,4150,685,184,30,16763
2021-10-14,16,8439,3422,4362,706,87,31,17047
2021-10-14,17,8435,3515,4393,640,26,31,17040
2021-10-14,18,8437,3017,4530,751,2,32,16769
2021-10-14,19,8430,2571,4517,1099,0,33,16650
2021-10-14,20,8423,2389,4635,1005,0,33,16485
2021-10-14,21,8414,2512,4387,730,0,33,16076
2021-10-14,22,8416,2079,4164,725,0,32,15416
2021-10-14,23,8427,1228,3981,692,0,25,14353
2021-10-14,24,8426,869,3882,706,0,17,13900
2021-10-15,1,8453,681,3816,708,0,17,13675
2021-10-15,2,8468,537,3858,585,0,17,13465
2021-10-15,3,8469,660,3865,454,0,17,13465
2021-10-15,4,8472,827,3884,372,0,18,13573
2021-10-15,5,8478,1074,3644,275,0,19,13490
2021-10-15,6,8474,1665,3835,213,2,26,14215
2021-10-15,7,8475,2676,4012,166,2,32,15363
2021-10-15,8,8417,3152,4106,72,22,32,15801
2021-10-15,9,8406,3359,4185,56,71,32,16109
2021-10-15,10,8411,3390,4283,51,77,31,16243
2021-10-15,11,8410,3355,4152,107,115,32,16171
2021-10-15,12,8413,3162,4304,118,142,32,16171
2021-10-15,13,8453,2952,4363,107,135,32,16042
2021-10-15,14,8510,3090,4411,88,102,32,16233
2021-10-15,15,8590,3038,4803,154,80,31,16696
2021-10-15,16,8601,2796,5010,225,44,31,16707
2021-10-15,17,8609,3274,5158,242,19,31,17333
2021-10-15,18,8606,3424,5046,214,1,31,17322
2021-10-15,19,8615,3172,5035,316,0,32,17170
2021-10-15,20,8610,2426,4769,629,0,33,16467
2021-10-15,21,8603,1276,4020,1605,0,33,15537
2021-10-15,22,8615,809,3922,1494,0,32,14872
2021-10-15,23,8628,274,4344,1085,0,16,14347
2021-10-15,24,8632,202,4362,766,0,2,13964
2021-10-16,1,8637,208,4204,614,0,0,13663
2021-10-16,2,8637,140,3853,681,0,0,13311
2021-10-16,3,8629,139,4065,736,0,0,13569
2021-10-16,4,8634,140,4154,789,0,0,13717
2021-10-16,5,8634,179,4280,805,0,0,13898
2021-10-16,6,8603,160,3970,1233,0,0,13966
2021-10-16,7,8573,236,3468,1773,2,0,14052
2021-10-16,8,8565,514,3611,1732,3,0,14425
2021-10-16,9,8561,554,3786,2094,28,0,15023
2021-10-16,10,8565,752,4436,2113,70,0,15936
2021-10-16,11,8564,796,4284,2221,91,0,15956
2021-10-16,12,8632,719,3935,2566,106,0,15958
2021-10-16,13,8654,693,3747,3101,129,0,16324
2021-10-16,14,8636,280,3463,2913,189,0,15481
2021-10-16,15,8637,460,3735,2379,146,0,15357
2021-10-16,16,8647,505,3900,2954,88,0,16094
2021-10-16,17,8646,504,4232,2993,47,0,16422
2021-10-16,18,8650,503,4103,2986,4,0,16246
2021-10-16,19,8661,503,4271,3372,0,0,16807
2021-10-16,20,8657,514,4021,3307,0,0,16499
2021-10-16,21,8657,284,3924,3179,0,0,16044
2021-10-16,22,8663,130,3888,3112,0,0,15793
2021-10-16,23,8671,129,3261,2851,0,1,14913
2021-10-16,24,8675,129,3277,2495,0,0,14576
2021-10-17,1,8687,129,3056,2414,0,0,14286
2021-10-17,2,8686,129,2884,2366,0,0,14065
2021-10-17,3,8710,129,3004,2058,0,0,13901
2021-10-17,4,8720,129,3091,1852,0,0,13792
2021-10-17,5,8716,129,3118,1943,0,0,13906
2021-10-17,6,8723,129,3174,2287,0,0,14313
2021-10-17,7,8739,130,3645,2174,3,0,14691
2021-10-17,8,8737,154,4100,1936,36,0,14963
2021-10-17,9,8735,147,4202,1694,69,0,14847
2021-10-17,10,8746,218,4618,1604,162,0,15348
2021-10-17,11,8747,195,3952,2005,156,0,15055
2021-10-17,12,8753,244,3498,2196,175,0,14866
2021-10-17,13,8759,587,3491,1838,146,0,14821
2021-10-17,14,8723,632,3637,1998,126,0,15116
2021-10-17,15,8779,728,4015,1740,171,0,15433
2021-10-17,16,8787,833,4240,1343,151,0,15354
2021-10-17,17,8794,833,4494,1598,63,0,15782
2021-10-17,18,8806,828,4581,1691,5,0,15911
2021-10-17,19,8810,874,4757,1886,0,0,16327
2021-10-17,20,8808,589,4566,2241,0,0,16204
2021-10-17,21,8807,467,4254,2757,0,0,16285
2021-10-17,22,8812,223,3838,2774,0,0,15647
2021-10-17,23,8813,151,3223,2805,0,0,14992
2021-10-17,24,8812,173,3140,2402,0,0,14527
2021-10-18,1,8815,186,2960,1923,0,8,13892
2021-10-18,2,8818,178,3066,1828,0,16,13906
2021-10-18,3,8824,297,2980,1774,0,18,13893
2021-10-18,4,8814,512,3027,1665,0,18,14036
2021-10-18,5,8813,899,3136,1497,0,21,14366
2021-10-18,6,8815,1073,3573,1505,2,28,14996
2021-10-18,7,8810,1202,4272,1889,3,29,16205
2021-10-18,8,8809,1373,4067,1944,51,31,16275
2021-10-18,9,8818,1419,4153,1830,165,32,16417
2021-10-18,10,8826,1512,3868,2005,247,33,16491
2021-10-18,11,8839,1489,3644,2108,299,32,16411
2021-10-18,12,8847,1475,3549,1971,337,33,16212
2021-10-18,13,8854,1265,3774,1644,312,32,15881
2021-10-18,14,8852,1274,3701,1514,293,32,15666
2021-10-18,15,8844,1569,3658,1136,322,32,15561
2021-10-18,16,8836,1782,3913,951,232,32,15746
2021-10-18,17,8832,1916,4788,1009,103,32,16680
2021-10-18,18,8835,2338,4923,625,8,32,16761
2021-10-18,19,8835,2445,4864,629,0,32,16805
2021-10-18,20,8837,1948,4523,781,0,32,16121
2021-10-18,21,8837,2081,4189,796,0,33,15936
2021-10-18,22,8822,1732,3864,667,0,32,15117
2021-10-18,23,8838,901,3522,785,0,21,14067
2021-10-18,24,8850,244,3224,1013,0,16,13347
2021-10-19,1,8857,136,3356,1107,0,15,13471
2021-10-19,2,8861,136,3568,1091,0,15,13671
2021-10-19,3,8847,169,3688,1073,0,16,13793
2021-10-19,4,8842,345,3919,1096,0,17,14219
2021-10-19,5,8839,741,3817,1044,0,22,14463
2021-10-19,6,8840,1060,4030,1111,1,28,15070
2021-10-19,7,8840,1328,4729,1127,3,32,16059
2021-10-19,8,8846,1334,4489,1117,89,33,15908
2021-10-19,9,8844,1288,4381,1006,244,33,15796
2021-10-19,10,8844,1770,4297,667,354,43,15975
2021-10-19,11,8847,1728,3963,736,409,56,15739
2021-10-19,12,8847,1249,3822,990,419,56,15383
2021-10-19,13,8850,1376,3677,1070,420,55,15448
2021-10-19,14,8851,1617,3877,1227,401,53,16026
2021-10-19,15,8859,1519,3818,1454,336,55,16041
2021-10-19,16,8847,1456,3986,1561,232,54,16136
2021-10-19,17,8852,1588,4574,1516,91,51,16672
2021-10-19,18,8854,1901,4558,1645,4,41,17003
2021-10-19,19,8853,1760,4326,1816,0,32,16787
2021-10-19,20,8849,1512,4125,2030,0,32,16548
2021-10-19,21,8851,1127,3760,2282,0,33,16053
2021-10-19,22,8845,629,3545,2224,0,34,15277
2021-10-19,23,8852,194,3389,2501,0,20,14956
2021-10-19,24,8854,135,3043,2554,0,16,14602
2021-10-20,1,8853,133,2798,2329,0,16,14129
2021-10-20,2,8855,158,2833,2295,0,16,14157
2021-10-20,3,8858,345,2845,2185,0,16,14249
2021-10-20,4,8862,667,2814,2015,0,16,14374
2021-10-20,5,8852,1270,2819,1651,0,21,14613
2021-10-20,6,8853,1674,3034,1503,2,27,15093
2021-10-20,7,8851,1795,3748,1648,3,32,16077
2021-10-20,8,8851,1895,4047,1447,71,32,16343
2021-10-20,9,8851,1847,4209,1104,193,29,16233
2021-10-20,10,8849,2051,4249,889,264,31,16333
2021-10-20,11,8844,1913,4105,755,253,31,15901
2021-10-20,12,8832,2141,3998,768,304,32,16075
2021-10-20,13,8831,1937,3934,1005,266,32,16005
2021-10-20,14,8831,1640,3849,1290,204,32,15846
2021-10-20,15,8832,1692,3719,1382,160,33,15818
2021-10-20,16,8833,1777,3904,1582,95,33,16224
2021-10-20,17,8836,1957,4378,1385,47,35,16638
2021-10-20,18,8835,2469,4429,1090,3,32,16858
2021-10-20,19,8837,2550,4266,1200,0,33,16886
2021-10-20,20,8835,1984,4156,1625,0,33,16633
2021-10-20,21,8832,1305,3923,1602,0,34,15696
2021-10-20,22,8834,684,3729,1646,0,33,14926
2021-10-20,23,8838,390,3526,1662,0,23,14439
2021-10-20,24,8841,341,3397,1624,0,16,14219
2021-10-21,1,8843,175,3196,1669,0,16,13899
2021-10-21,2,8843,218,3170,1731,0,16,13978
2021-10-21,3,8848,446,3037,1682,0,16,14029
2021-10-21,4,8850,765,2966,1636,0,16,14233
2021-10-21,5,8850,1017,2851,1615,0,20,14353
2021-10-21,6,8843,1368,2987,1527,0,30,14755
2021-10-21,7,8843,1680,3467,1871,2,32,15895
2021-10-21,8,8840,1901,3551,2129,8,32,16461
2021-10-21,9,8842,1971,4027,2071,21,36,16968
2021-10-21,10,8845,2159,4077,2041,38,36,17196
2021-10-21,11,8832,1959,3961,2126,85,32,16995
2021-10-21,12,8820,1749,3835,2139,92,33,16668
2021-10-21,13,8819,1422,3599,2414,106,32,16392
2021-10-21,14,8819,1182,3725,2365,140,32,16263
2021-10-21,15,8836,1473,4159,2492,77,33,17070
2021-10-21,16,8838,1539,4045,2668,57,27,17174
2021-10-21,17,8841,1183,3950,2908,23,29,16934
2021-10-21,18,8840,1145,3932,3101,0,32,17050
2021-10-21,19,8837,792,4170,3208,0,32,17039
2021-10-21,20,8834,724,4165,2971,0,35,16729
2021-10-21,21,8831,754,3931,2815,0,33,16364
2021-10-21,22,8829,591,3754,2891,0,32,16097
2021-10-21,23,8833,231,3275,2960,0,23,15322
2021-10-21,24,8838,133,3443,2678,0,16,15108
2021-10-22,1,8834,134,3311,2677,0,15,14971
2021-10-22,2,8832,150,3217,2546,0,15,14760
2021-10-22,3,8839,349,3395,2088,0,16,14687
2021-10-22,4,8829,721,3600,1666,0,16,14832
2021-10-22,5,8845,1324,3361,1186,0,20,14736
2021-10-22,6,8842,1936,3576,972,1,29,15356
2021-10-22,7,8848,2498,3813,880,2,33,16074
2021-10-22,8,8851,2750,3945,702,32,33,16313
2021-10-22,9,8773,2966,4076,545,134,32,16526
2021-10-22,10,8765,2915,4032,416,260,32,16420
2021-10-22,11,8762,2792,3986,338,279,32,16189
2021-10-22,12,8769,2678,4073,250,261,33,16064
2021-10-22,13,8768,2478,4211,124,247,33,15861
2021-10-22,14,8770,2225,4188,127,262,33,15605
2021-10-22,15,8777,2194,4293,103,200,33,15600
2021-10-22,16,8797,2521,4449,98,121,33,16019
2021-10-22,17,8874,2133,4731,113,43,33,15927
2021-10-22,18,8877,2278,4777,123,1,33,16089
2021-10-22,19,8874,2349,4730,105,0,33,16091
2021-10-22,20,8873,2018,4643,129,0,33,15696
2021-10-22,21,8870,2089,4528,170,0,33,15690
2021-10-22,22,8865,1655,3836,178,0,33,14567
2021-10-22,23,8867,966,3843,176,0,25,13877
2021-10-22,24,8864,392,4226,188,0,14,13684
2021-10-23,1,8864,249,4025,223,0,3,13364
2021-10-23,2,8865,162,3781,230,0,0,13038
2021-10-23,3,8865,254,3877,190,0,0,13186
2021-10-23,4,8868,652,3880,168,0,0,13568
2021-10-23,5,8867,1012,3874,132,0,0,13885
2021-10-23,6,8864,1331,3510,174,1,0,13880
2021-10-23,7,8860,1371,3636,179,3,0,14049
2021-10-23,8,8868,1667,3972,146,49,0,14702
2021-10-23,9,8868,1553,4182,145,130,0,14878
2021-10-23,10,8868,1506,4326,73,209,0,14982
2021-10-23,11,8862,1348,4204,77,235,0,14726
2021-10-23,12,8858,1181,3980,141,289,0,14449
2021-10-23,13,8855,1330,3589,184,267,0,14225
2021-10-23,14,8853,1328,3516,315,189,0,14201
2021-10-23,15,8855,1164,3896,254,126,0,14295
2021-10-23,16,8859,1116,4472,175,86,0,14708
2021-10-23,17,8865,1135,4836,122,35,0,14993
2021-10-23,18,8888,1619,5117,73,0,0,15697
2021-10-23,19,8903,1429,5031,107,0,0,15470
2021-10-23,20,8941,1001,5020,104,0,0,15066
2021-10-23,21,8961,818,4930,132,0,0,14841
2021-10-23,22,8958,853,4296,149,0,0,14256
2021-10-23,23,8960,481,3841,181,0,0,13463
2021-10-23,24,8958,499,3501,159,0,0,13117
2021-10-24,1,9033,335,3685,145,0,0,13198
2021-10-24,2,9175,320,3381,164,0,0,13040
2021-10-24,3,9186,398,3584,232,0,0,13400
2021-10-24,4,9187,459,3651,196,0,0,13493
2021-10-24,5,9189,452,3682,172,0,0,13495
2021-10-24,6,9192,513,4044,209,2,0,13960
2021-10-24,7,9193,877,4057,186,3,0,14316
2021-10-24,8,9195,947,4432,151,71,0,14796
2021-10-24,9,9207,922,4185,119,205,0,14638
2021-10-24,10,9230,1000,4284,107,265,0,14886
2021-10-24,11,9237,1248,4364,144,313,0,15306
2021-10-24,12,9233,1532,4481,154,270,0,15670
2021-10-24,13,9236,1573,4575,152,186,0,15722
2021-10-24,14,9315,1275,4531,163,147,0,15431
2021-10-24,15,9314,1193,4455,183,111,0,15256
2021-10-24,16,9313,1405,3873,222,75,0,14888
2021-10-24,17,9315,1554,4637,246,23,0,15775
2021-10-24,18,9311,1616,4905,357,0,0,16189
2021-10-24,19,9311,1433,4716,707,0,0,16167
2021-10-24,20,9310,1037,4521,1127,0,0,15995
2021-10-24,21,9315,606,4391,1364,0,0,15676
2021-10-24,22,9305,549,3978,1642,0,0,15474
2021-10-24,23,9294,213,3250,1886,0,0,14643
2021-10-24,24,9294,134,3146,2127,0,0,14701
2021-10-25,1,9303,138,3098,2170,0,2,14711
2021-10-25,2,9309,135,2924,2283,0,13,14664
2021-10-25,3,9309,194,2928,2200,0,16,14647
2021-10-25,4,9309,293,2853,2316,0,18,14789
2021-10-25,5,9303,398,3096,2581,0,20,15398
2021-10-25,6,9299,618,3326,2628,0,27,15898
2021-10-25,7,9297,877,4487,2528,2,31,17222
2021-10-25,8,9292,1095,4400,2599,4,32,17422
2021-10-25,9,9296,1175,4230,2907,18,33,17659
2021-10-25,10,9297,1513,4352,3056,38,34,18290
2021-10-25,11,9297,1994,4350,3113,42,32,18828
2021-10-25,12,9290,1960,4124,3140,49,32,18595
2021-10-25,13,9301,2266,3913,3204,46,32,18762
2021-10-25,14,9283,2075,3670,3265,43,32,18368
2021-10-25,15,9280,1741,3699,3542,46,32,18340
2021-10-25,16,9281,1760,4029,3582,27,32,18711
2021-10-25,17,9275,1852,4399,3604,8,32,19170
2021-10-25,18,9274,1839,4170,3722,0,33,19038
2021-10-25,19,9266,1428,3896,3863,0,33,18486
2021-10-25,20,9270,677,3729,4044,0,33,17753
2021-10-25,21,9270,381,3778,3924,0,38,17391
2021-10-25,22,9270,347,3475,3672,0,34,16798
2021-10-25,23,9273,350,3010,3308,0,24,15965
2021-10-25,24,9274,179,2990,3153,0,18,15614
2021-10-26,1,9276,139,3019,2745,0,18,15197
2021-10-26,2,9282,142,2966,2694,0,18,15102
2021-10-26,3,9290,148,2953,2570,0,18,14979
2021-10-26,4,9289,259,2939,2623,0,18,15128
2021-10-26,5,9292,517,3237,2795,0,21,15862
2021-10-26,6,9288,828,3325,2779,0,27,16247
2021-10-26,7,9288,949,4056,2912,1,31,17237
2021-10-26,8,9289,1054,4227,2984,8,31,17593
2021-10-26,9,9291,1061,4242,3067,45,31,17737
2021-10-26,10,9291,1241,4329,3230,77,32,18200
2021-10-26,11,9289,1474,4090,3323,108,32,18316
2021-10-26,12,9288,1193,4106,3255,103,33,17978
2021-10-26,13,9301,1269,3765,3362,77,32,17806
2021-10-26,14,9307,1236,3894,3476,67,36,18016
2021-10-26,15,9298,1156,4142,3529,60,32,18217
2021-10-26,16,9298,1138,4268,3486,39,33,18262
2021-10-26,17,9294,1135,4606,3412,16,34,18497
2021-10-26,18,9290,1127,4738,3193,0,35,18383
2021-10-26,19,9291,797,4501,2997,0,33,17619
2021-10-26,20,9289,422,4266,2943,0,33,16953
2021-10-26,21,9289,353,4448,2741,0,33,16864
2021-10-26,22,9299,195,4146,2487,0,33,16160
2021-10-26,23,9303,129,3771,2175,0,26,15404
2021-10-26,24,9310,129,3897,1886,0,18,15240
2021-10-27,1,9317,151,3882,1590,0,18,14958
2021-10-27,2,9312,170,3887,1253,0,18,14640
2021-10-27,3,9314,329,3804,1093,0,18,14558
2021-10-27,4,9318,966,3461,995,0,18,14758
2021-10-27,5,9321,1744,2998,821,0,21,14905
2021-10-27,6,9316,2055,3257,749,0,29,15406
2021-10-27,7,9316,2434,3895,646,1,35,16327
2021-10-27,8,9313,2909,3635,555,32,34,16478
2021-10-27,9,9308,2753,3623,527,135,33,16379
2021-10-27,10,9311,2389,3605,501,216,33,16055
2021-10-27,11,9312,2196,3701,416,254,33,15912
2021-10-27,12,9312,2000,3736,327,316,33,15724
2021-10-27,13,9305,1806,3745,277,352,33,15518
2021-10-27,14,9303,2032,3553,267,341,33,15529
2021-10-27,15,9299,2329,3751,233,274,33,15919
2021-10-27,16,9294,2409,3905,249,183,32,16072
2021-10-27,17,9290,2473,4480,279,62,33,16617
2021-10-27,18,9298,2848,4535,362,2,27,17072
2021-10-27,19,9287,3015,4471,547,0,17,17337
2021-10-27,20,9292,2745,4246,752,0,22,17057
2021-10-27,21,9327,1989,4078,926,0,29,16349
2021-10-27,22,9325,892,4105,1004,0,31,15357
2021-10-27,23,9323,567,3709,1044,0,22,14665
2021-10-27,24,9329,292,3273,1089,0,17,14000
2021-10-28,1,9330,134,3093,1528,0,17,14102
2021-10-28,2,9333,134,2774,1905,0,17,14163
2021-10-28,3,9337,144,2762,1940,0,17,14200
2021-10-28,4,9334,252,2836,2161,0,17,14600
2021-10-28,5,9336,478,2805,1735,0,20,14374
2021-10-28,6,9333,742,3091,1881,2,31,15080
2021-10-28,7,9330,753,3553,2503,2,35,16176
2021-10-28,8,9329,754,3550,2710,43,28,16414
2021-10-28,9,9329,755,3864,2798,105,28,16879
2021-10-28,10,9326,750,3753,2856,185,27,16897
2021-10-28,11,9326,748,3682,2939,225,27,16947
2021-10-28,12,9319,244,3636,2727,270,27,16223
2021-10-28,13,9318,133,3589,2635,323,27,16025
2021-10-28,14,9320,187,3525,2510,320,28,15890
2021-10-28,15,9318,324,3640,2308,252,28,15870
2021-10-28,16,9319,325,3618,2671,134,27,16094
2021-10-28,17,9318,324,4091,2989,36,27,16785
2021-10-28,18,9310,329,4213,3219,1,26,17098
2021-10-28,19,9311,327,4179,3278,0,26,17121
2021-10-28,20,9317,328,4057,3429,0,26,17157
2021-10-28,21,9322,186,3661,3435,0,26,16630
2021-10-28,22,9326,129,3395,3405,0,26,16281
2021-10-28,23,9329,132,2976,3251,0,18,15706
2021-10-28,24,9329,134,2792,2809,0,17,15081
2021-10-29,1,9327,133,2705,2601,0,17,14783
2021-10-29,2,9323,134,2585,2410,0,17,14469
2021-10-29,3,9330,134,2524,2353,0,17,14358
2021-10-29,4,9328,134,2595,2365,0,18,14440
2021-10-29,5,9330,134,2594,2433,0,22,14513
2021-10-29,6,9327,135,2821,2633,0,27,14943
2021-10-29,7,9326,146,3712,2768,1,32,15985
2021-10-29,8,9323,179,4360,2702,32,32,16628
2021-10-29,9,9330,225,4593,2483,104,32,16767
2021-10-29,10,9325,273,4454,2327,171,33,16583
2021-10-29,11,9316,224,4195,2384,201,32,16352
2021-10-29,12,9316,144,3868,2513,189,32,16062
2021-10-29,13,9315,185,3803,2573,170,33,16079
2021-10-29,14,9308,146,3473,2973,132,33,16065
2021-10-29,15,9314,132,3527,3090,104,33,16200
2021-10-29,16,9315,150,3915,3066,34,33,16513
2021-10-29,17,9320,176,4301,3377,6,31,17211
2021-10-29,18,9321,135,4211,3491,0,31,17189
2021-10-29,19,9319,133,3972,3359,0,28,16811
2021-10-29,20,9322,133,4142,3187,0,28,16812
2021-10-29,21,9327,133,4240,3155,0,32,16887
2021-10-29,22,9330,139,3812,2978,0,32,16291
2021-10-29,23,9336,132,3248,2707,0,26,15449
2021-10-29,24,9329,132,3011,2238,0,16,14726
2021-10-30,1,9326,133,2980,1978,0,11,14428
2021-10-30,2,9316,133,2862,1930,0,0,14241
2021-10-30,3,9321,132,2608,1882,0,0,13943
2021-10-30,4,9323,145,2727,1872,0,0,14067
2021-10-30,5,9329,251,2979,1702,0,0,14261
2021-10-30,6,9331,321,3250,1518,0,0,14420
2021-10-30,7,9332,503,3424,1328,1,0,14588
2021-10-30,8,9329,783,3470,1228,5,0,14815
2021-10-30,9,9326,899,3887,1189,33,0,15334
2021-10-30,10,9322,1060,4150,1078,65,0,15675
2021-10-30,11,9318,1260,4315,834,93,1,15821
2021-10-30,12,9331,1290,4283,655,112,0,15671
2021-10-30,13,9349,1081,4190,561,106,0,15287
2021-10-30,14,9352,1208,4254,477,87,0,15378
2021-10-30,15,9357,1423,4345,406,71,0,15602
2021-10-30,16,9356,1507,4645,355,45,0,15908
2021-10-30,17,9357,1799,4652,280,9,0,16097
2021-10-30,18,9355,1581,4680,259,0,0,15875
2021-10-30,19,9352,1321,4661,276,0,0,15610
2021-10-30,20,9349,1156,4477,288,0,0,15270
2021-10-30,21,9346,1076,4233,226,0,0,14881
2021-10-30,22,9346,671,3851,200,0,0,14068
2021-10-30,23,9347,244,3453,181,0,11,13236
2021-10-30,24,9352,172,3462,260,0,40,13286
2021-10-31,1,9352,203,3219,331,0,51,13156
2021-10-31,2,9354,165,3295,367,0,49,13230
2021-10-31,3,9360,165,3210,411,0,51,13197
2021-10-31,4,9362,165,2848,526,0,50,12951
2021-10-31,5,9368,162,2957,704,0,40,13231
2021-10-31,6,9363,199,3350,716,0,9,13637
2021-10-31,7,9373,198,3530,760,2,48,13911
2021-10-31,8,9367,169,3844,927,8,50,14365
2021-10-31,9,9363,163,4217,839,46,50,14678
2021-10-31,10,9362,213,4277,1145,110,25,15132
2021-10-31,11,9363,161,3989,1180,129,49,14871
2021-10-31,12,9358,186,3631,1320,171,47,14713
2021-10-31,13,9357,212,3358,1803,167,47,14944
2021-10-31,14,9362,220,3295,2392,160,47,15476
2021-10-31,15,9362,323,3422,2473,121,47,15748
2021-10-31,16,9354,324,3539,2534,80,47,15878
2021-10-31,17,9347,325,3830,2624,8,47,16181
2021-10-31,18,9341,324,3707,2527,0,47,15946
2021-10-31,19,9345,167,3846,2668,0,48,16074
2021-10-31,20,9347,129,3907,3011,0,48,16442
2021-10-31,21,9352,130,3423,3605,0,47,16557
2021-10-31,22,9352,129,3241,3073,0,48,15843
2021-10-31,23,9349,129,3165,2253,0,48,14944
2021-10-31,24,9352,129,3081,1815,0,48,14425
2021-11-01,1,9348,130,2834,2051,0,48,14411
2021-11-01,2,9347,142,2837,1897,0,48,14271
2021-11-01,3,9350,158,2815,1657,0,61,14041
2021-11-01,4,9349,170,2806,1815,0,66,14206
2021-11-01,5,9348,192,2796,2521,0,67,14924
2021-11-01,6,9355,330,2820,2787,0,76,15368
2021-11-01,7,9353,443,3433,2780,2,80,16091
2021-11-01,8,9355,476,3413,2651,51,80,16026
2021-11-01,9,9356,323,3614,2377,192,80,15942
2021-11-01,10,9354,314,3668,2272,261,81,15950
2021-11-01,11,9347,391,3634,2722,257,90,16441
2021-11-01,12,9340,421,3519,2805,255,95,16435
2021-11-01,13,9337,475,3586,2915,216,96,16625
2021-11-01,14,9331,825,3639,2525,270,107,16697
2021-11-01,15,9330,945,3746,2500,197,106,16824
2021-11-01,16,9331,1119,3886,2360,91,63,16850
2021-11-01,17,9329,1229,4152,2118,20,54,16902
2021-11-01,18,9327,1639,4240,1893,1,43,17143
2021-11-01,19,9325,1224,4201,2111,0,33,16894
2021-11-01,20,9318,1130,3736,2245,0,32,16461
2021-11-01,21,9324,724,3797,2086,0,32,15963
2021-11-01,22,9305,177,3407,2370,0,32,15291
2021-11-01,23,9331,131,3365,2130,0,20,14977
2021-11-01,24,9330,130,3155,2101,0,18,14734
2021-11-02,1,9340,132,2907,2035,0,18,14432
2021-11-02,2,9343,171,2760,2000,0,19,14293
2021-11-02,3,9349,207,2869,1885,0,18,14328
2021-11-02,4,9351,451,3152,1948,0,18,14920
2021-11-02,5,9353,669,2791,1957,0,20,14790
2021-11-02,6,9351,1066,2857,1962,0,26,15262
2021-11-02,7,9353,1282,3649,2316,2,32,16634
2021-11-02,8,9362,1484,3905,2218,22,32,17023
2021-11-02,9,9364,1611,4181,1805,136,31,17128
2021-11-02,10,9366,1596,4235,1769,243,33,17242
2021-11-02,11,9370,1392,4004,2235,306,36,17343
2021-11-02,12,9369,1046,3813,2353,303,50,16934
2021-11-02,13,9369,1199,4272,2353,226,50,17469
2021-11-02,14,9370,1442,4101,2301,209,44,17467
2021-11-02,15,9372,1604,4133,1904,147,34,17194
2021-11-02,16,9374,1789,4124,1873,56,32,17248
2021-11-02,17,9371,1751,4477,1796,20,32,17447
2021-11-02,18,9376,1818,4822,1772,0,32,17820
2021-11-02,19,9377,1782,4695,1679,0,32,17565
2021-11-02,20,9380,1550,4495,1730,0,32,17187
2021-11-02,21,9382,813,4278,1965,0,32,16470
2021-11-02,22,9382,288,3869,1927,0,32,15498
2021-11-02,23,9386,135,3719,1907,0,20,15167
2021-11-02,24,9391,134,3912,1769,0,19,15225
2021-11-03,1,9389,196,3696,1612,0,21,14914
2021-11-03,2,9389,336,3741,1485,0,26,14977
2021-11-03,3,9391,664,3543,1268,0,29,14895
2021-11-03,4,9383,1138,3454,1182,0,29,15186
2021-11-03,5,9397,1706,3182,944,0,38,15267
2021-11-03,6,9396,2019,3719,904,0,41,16079
2021-11-03,7,9401,2953,4744,889,2,45,18034
2021-11-03,8,9399,3039,4735,810,24,46,18053
2021-11-03,9,9400,3086,4575,571,134,44,17810
2021-11-03,10,9399,2555,4342,572,222,46,17136
2021-11-03,11,9399,2341,3862,722,291,47,16662
2021-11-03,12,9396,2309,3585,684,291,47,16312
2021-11-03,13,9401,2361,3713,786,246,45,16552
2021-11-03,14,9402,2471,3923,740,192,44,16772
2021-11-03,15,9396,2609,4175,638,121,39,16978
2021-11-03,16,9397,2816,4382,483,61,39,17178
2021-11-03,17,9395,3531,4843,330,20,33,18152
2021-11-03,18,9395,3905,4874,239,0,27,18440
2021-11-03,19,9391,3520,4788,213,0,27,17939
2021-11-03,20,9393,3164,4558,233,0,26,17374
2021-11-03,21,9396,2507,4435,226,0,29,16593
2021-11-03,22,9396,1938,4028,190,0,32,15584
2021-11-03,23,9393,1101,3797,198,0,21,14510
2021-11-03,24,9391,982,3948,229,0,16,14566
2021-11-04,1,9394,1034,3783,332,0,15,14558
2021-11-04,2,9397,1019,3717,336,0,15,14484
2021-11-04,3,9401,1160,3688,283,0,16,14548
2021-11-04,4,9399,1333,3591,314,0,16,14653
2021-11-04,5,9402,1631,3533,327,0,21,14914
2021-11-04,6,9408,2414,3981,311,1,27,16142
2021-11-04,7,9405,3473,4747,251,2,31,17909
2021-11-04,8,9403,3750,4623,272,15,32,18095
2021-11-04,9,9409,3512,4705,246,67,31,17970
2021-11-04,10,9402,3180,4562,250,121,31,17546
2021-11-04,11,9395,2717,4265,250,180,32,16839
2021-11-04,12,9393,2406,4126,311,187,32,16455
2021-11-04,13,9395,2765,4022,337,201,32,16752
2021-11-04,14,9394,2706,3964,334,191,29,16618
2021-11-04,15,9393,2573,3968,311,106,26,16377
2021-11-04,16,9393,3061,4407,261,63,26,17211
2021-11-04,17,9394,4036,4860,157,14,26,18487
2021-11-04,18,9388,4538,4833,153,0,27,18939
2021-11-04,19,9394,4383,4768,160,0,27,18732
2021-11-04,20,9394,3887,4575,176,0,32,18064
2021-11-04,21,9390,2730,4508,174,0,33,16835
2021-11-04,22,9382,2107,4247,218,0,31,15985
2021-11-04,23,9395,1365,3929,257,0,20,14966
2021-11-04,24,9396,897,3746,309,0,16,14364
2021-11-05,1,9397,957,3293,355,0,16,14018
2021-11-05,2,9399,836,3206,361,0,16,13818
2021-11-05,3,9397,1138,2997,450,0,16,13998
2021-11-05,4,9400,1545,3063,493,0,18,14519
2021-11-05,5,9332,1990,3186,362,0,22,14892
2021-11-05,6,8594,3075,4237,336,0,27,16269
2021-11-05,7,8598,3722,4807,342,2,31,17502
2021-11-05,8,8609,3666,4746,360,27,37,17445
2021-11-05,9,9018,3282,4678,449,119,31,17577
2021-11-05,10,9248,2337,4328,509,214,31,16667
2021-11-05,11,9323,2244,4204,510,292,41,16614
2021-11-05,12,9384,1788,4147,617,313,44,16293
2021-11-05,13,9362,1919,3954,723,357,37,16352
2021-11-05,14,9358,2026,4025,750,353,31,16543
2021-11-05,15,9398,2223,3753,674,234,41,16323
2021-11-05,16,9220,2274,3939,699,141,85,16358
2021-11-05,17,9042,2329,4246,894,39,147,16697
2021-11-05,18,8876,2562,4960,1015,1,173,17587
2021-11-05,19,8803,2549,4877,1252,0,177,17658
2021-11-05,20,8660,2304,4723,1328,0,180,17195
2021-11-05,21,8614,1852,4412,1475,0,181,16534
2021-11-05,22,8573,1220,3959,1573,0,181,15506
2021-11-05,23,8572,957,3591,1658,0,144,14922
2021-11-05,24,8564,539,3082,1493,0,71,13749
2021-11-06,1,8575,173,3126,1607,0,25,13506
2021-11-06,2,8575,152,3356,1424,0,14,13521
2021-11-06,3,8573,230,3288,1382,0,24,13497
2021-11-06,4,8573,361,3237,1372,0,23,13566
2021-11-06,5,8572,424,2839,1445,0,20,13300
2021-11-06,6,8569,603,2937,1299,0,13,13421
2021-11-06,7,8572,909,3516,1657,2,7,14663
2021-11-06,8,8576,1167,4053,1677,31,2,15506
2021-11-06,9,8575,1440,4109,1504,151,0,15779
2021-11-06,10,8574,1415,4068,1273,262,0,15592
2021-11-06,11,8572,1157,3536,1461,332,0,15058
2021-11-06,12,8573,961,3263,1744,340,0,14881
2021-11-06,13,8566,626,3137,1695,367,0,14391
2021-11-06,14,8571,884,3071,1503,345,0,14374
2021-11-06,15,8575,898,3302,1824,248,0,14847
2021-11-06,16,8575,905,3816,1677,158,0,15131
2021-11-06,17,8574,1165,4558,1510,33,0,15840
2021-11-06,18,8573,1282,4751,1658,1,0,16265
2021-11-06,19,8569,1029,4522,1963,0,0,16083
2021-11-06,20,8567,530,4156,2206,0,0,15459
2021-11-06,21,8570,438,3911,2319,0,0,15238
2021-11-06,22,8548,406,3413,2355,0,0,14722
2021-11-06,23,8573,178,3342,2289,0,0,14382
2021-11-06,24,8569,132,3038,2319,0,0,14058
2021-11-07,1,8567,140,3211,2281,0,0,14199
2021-11-07,2,8546,128,2988,2208,0,0,13870
2021-11-07,3,8556,129,3150,2117,0,0,13952
2021-11-07,4,8565,131,3268,2029,0,0,13993
2021-11-07,5,8568,185,3439,2007,0,0,14199
2021-11-07,6,8567,254,3732,2116,0,0,14669
2021-11-07,7,8571,240,3661,2117,10,0,14599
2021-11-07,8,8567,242,3657,2112,36,0,14614
2021-11-07,9,8563,153,3603,1995,159,0,14473
2021-11-07,10,8565,255,3790,1600,277,0,14487
2021-11-07,11,8562,418,3855,1421,345,0,14601
2021-11-07,12,8563,713,3994,1259,373,0,14902
2021-11-07,13,8562,1297,4070,1128,372,0,15429
2021-11-07,14,8559,1940,3759,1207,346,0,15811
2021-11-07,15,8559,2035,3554,1124,271,0,15543
2021-11-07,16,8560,2030,3941,1043,155,0,15729
2021-11-07,17,8556,2076,4303,1019,31,0,15985
2021-11-07,18,8555,2503,4582,1291,0,0,16931
2021-11-07,19,8554,2168,4384,1501,0,0,16607
2021-11-07,20,8552,1459,4531,1530,0,0,16072
2021-11-07,21,8547,899,4433,1592,0,0,15471
2021-11-07,22,8544,449,3681,1614,0,0,14288
2021-11-07,23,8544,167,3329,1562,0,0,13602
2021-11-07,24,8549,130,3260,1409,0,0,13348
2021-11-08,1,8547,133,3398,1290,0,0,13368
2021-11-08,2,8542,163,3426,1349,0,7,13487
2021-11-08,3,8548,235,3357,1558,0,14,13712
2021-11-08,4,8546,372,3149,1673,0,15,13755
2021-11-08,5,8547,505,3130,1768,0,15,13965
2021-11-08,6,8544,770,3271,1526,0,19,14130
2021-11-08,7,8547,1164,3782,2355,2,29,15879
2021-11-08,8,8547,1604,3888,2652,21,28,16740
2021-11-08,9,8549,1960,3766,2675,125,27,17102
2021-11-08,10,8544,1928,3556,2494,263,27,16812
2021-11-08,11,8545,1898,3325,2546,345,27,16686
2021-11-08,12,8547,1904,3285,2573,384,27,16720
2021-11-08,13,8544,1531,3187,2671,350,27,16310
2021-11-08,14,8548,1798,3135,2683,295,28,16487
2021-11-08,15,8546,1760,3704,2754,229,27,17020
2021-11-08,16,8543,1953,3770,2529,136,27,16958
2021-11-08,17,8541,2170,4464,2597,32,27,17831
2021-11-08,18,8541,2910,4663,2757,1,26,18898
2021-11-08,19,8535,2441,4541,2842,0,28,18387
2021-11-08,20,8530,1926,4297,2634,0,30,17417
2021-11-08,21,8530,1772,4097,2391,0,30,16820
2021-11-08,22,8529,1799,3521,2081,0,32,15962
2021-11-08,23,8529,1410,3243,1836,0,37,15055
2021-11-08,24,8527,649,2986,1716,0,55,13933
2021-11-09,1,8527,370,3106,1693,0,67,13763
2021-11-09,2,8527,450,3243,1381,0,67,13668
2021-11-09,3,8532,493,3168,1153,0,66,13412
2021-11-09,4,8534,547,3135,908,0,67,13191
2021-11-09,5,8533,1109,3005,806,0,67,13520
2021-11-09,6,8531,1937,3358,453,0,69,14348
2021-11-09,7,8563,2692,3924,424,1,81,15685
2021-11-09,8,8571,3114,4274,660,12,84,16715
2021-11-09,9,8578,3506,4343,528,56,87,17098
2021-11-09,10,8576,3516,4228,263,144,88,16815
2021-11-09,11,8573,3013,4189,120,165,90,16150
2021-11-09,12,8576,3067,4197,65,242,90,16237
2021-11-09,13,8572,3091,3851,83,222,90,15909
2021-11-09,14,8572,3338,3923,124,123,89,16169
2021-11-09,15,8575,3611,3875,243,105,88,16497
2021-11-09,16,8573,3439,4156,415,42,86,16711
2021-11-09,17,8570,4081,4586,414,5,87,17743
2021-11-09,18,8570,4689,4684,416,0,88,18447
2021-11-09,19,8570,4168,4474,654,0,86,17952
2021-11-09,20,8565,3840,4093,678,0,86,17262
2021-11-09,21,8566,3754,3879,678,0,86,16963
2021-11-09,22,8559,3593,3714,426,0,90,16382
2021-11-09,23,8557,2571,3523,369,0,87,15107
2021-11-09,24,8557,1605,3456,379,0,78,14075
2021-11-10,1,8556,1354,3242,483,0,72,13707
2021-11-10,2,8560,1134,3087,721,0,69,13571
2021-11-10,3,8563,1226,2897,801,0,69,13556
2021-11-10,4,8560,1585,2996,861,0,69,14071
2021-11-10,5,8560,1803,3055,959,0,69,14446
2021-11-10,6,8556,2060,3241,571,0,72,14500
2021-11-10,7,8552,2459,4200,573,2,83,15869
2021-11-10,8,8548,3317,4523,285,32,87,16792
2021-11-10,9,8549,3310,4306,181,177,87,16610
2021-11-10,10,8552,2532,4163,85,305,89,15726
2021-11-10,11,8553,2487,4074,72,360,88,15634
2021-11-10,12,8550,2567,3771,144,372,87,15491
2021-11-10,13,8547,2836,3521,261,359,87,15611
2021-11-10,14,8544,2922,3121,303,324,84,15298
2021-11-10,15,8540,3020,3297,277,247,84,15465
2021-11-10,16,8542,3107,3865,261,113,83,15971
2021-11-10,17,8540,3737,4566,289,14,85,17231
2021-11-10,18,8542,4540,4739,355,0,89,18265
2021-11-10,19,8542,4316,4865,431,0,39,18193
2021-11-10,20,8543,4062,4793,405,0,51,17854
2021-11-10,21,8542,3933,4149,624,0,82,17330
2021-11-10,22,8511,3083,3587,1323,0,97,16601
2021-11-10,23,8505,1826,3142,1946,0,112,15531
2021-11-10,24,8504,1006,2776,2182,0,90,14558
2021-11-11,1,8500,443,2714,2515,0,71,14243
2021-11-11,2,8502,183,2663,2910,0,69,14327
2021-11-11,3,8503,132,2795,3111,0,70,14611
2021-11-11,4,8507,141,3063,2928,0,102,14741
2021-11-11,5,8434,169,3237,2832,0,105,14777
2021-11-11,6,8415,318,3254,2885,0,85,14957
2021-11-11,7,8412,782,3776,2877,3,87,15937
2021-11-11,8,8407,1469,4296,2894,13,84,17163
2021-11-11,9,8404,1388,4279,2818,77,85,17051
2021-11-11,10,8402,1568,4364,2575,98,103,17110
2021-11-11,11,8400,1611,4130,2613,131,129,17014
2021-11-11,12,8477,1411,3643,2828,141,91,16591
2021-11-11,13,8488,1281,3201,3046,149,88,16253
2021-11-11,14,8492,1310,3050,3191,198,118,16359
2021-11-11,15,8488,989,3144,3299,146,106,16172
2021-11-11,16,8488,943,3566,3552,50,84,16683
2021-11-11,17,8482,970,4032,3609,6,80,17179
2021-11-11,18,8486,1449,4642,3486,0,120,18183
2021-11-11,19,8483,1511,4466,3388,0,166,18014
2021-11-11,20,8483,1282,4182,3245,0,202,17394
2021-11-11,21,8477,1032,3757,3510,0,166,16942
2021-11-11,22,8478,973,3641,3063,0,131,16286
2021-11-11,23,8488,934,3610,2599,0,98,15729
2021-11-11,24,8490,517,4125,2097,0,74,15303
2021-11-12,1,8490,446,3251,2370,0,66,14623
2021-11-12,2,8492,145,2710,2723,0,68,14138
2021-11-12,3,8486,130,2557,2713,0,68,13954
2021-11-12,4,8484,130,2860,2972,0,68,14514
2021-11-12,5,8482,181,3374,2723,0,70,14830
2021-11-12,6,8477,250,3166,2636,0,71,14600
2021-11-12,7,8472,528,3554,2435,1,90,15080
2021-11-12,8,8470,683,4100,2453,8,98,15812
2021-11-12,9,8467,752,4182,2197,85,98,15781
2021-11-12,10,8468,798,4237,2359,127,91,16080
2021-11-12,11,8463,670,3482,3000,294,95,16004
2021-11-12,12,8461,568,3255,3242,310,98,15934
2021-11-12,13,8460,444,3312,3467,344,101,16128
2021-11-12,14,8463,748,3237,3644,337,93,16522
2021-11-12,15,8466,912,3549,3802,212,84,17025
2021-11-12,16,8465,1072,3637,3634,128,82,17018
2021-11-12,17,8460,1170,4342,3382,14,81,17449
2021-11-12,18,8459,1453,5039,3047,0,82,18080
2021-11-12,19,8455,1231,4687,3289,0,82,17744
2021-11-12,20,8454,1440,4661,2896,0,82,17533
2021-11-12,21,8453,1542,3991,2923,0,83,16992
2021-11-12,22,8452,1341,3351,3012,0,77,16233
2021-11-12,23,8452,863,3371,2879,0,76,15641
2021-11-12,24,8451,647,3322,2572,0,63,15055
2021-11-13,1,8453,305,3217,2653,0,53,14681
2021-11-13,2,8456,202,3266,2548,0,48,14520
2021-11-13,3,8459,218,3244,2583,0,47,14551
2021-11-13,4,8453,246,3259,2424,0,48,14430
2021-11-13,5,8454,310,3221,2466,0,48,14499
2021-11-13,6,8454,351,3428,2398,0,50,14681
2021-11-13,7,8455,468,3433,2492,2,71,14921
2021-11-13,8,8458,633,3989,2433,4,100,15617
2021-11-13,9,8459,812,4090,2657,22,125,16165
2021-11-13,10,8458,967,4108,2685,126,115,16459
2021-11-13,11,8458,1302,3799,2624,154,71,16408
2021-11-13,12,8459,1505,3177,2907,194,116,16358
2021-11-13,13,8464,1589,3256,3342,181,94,16926
2021-11-13,14,8458,1593,3201,3449,171,69,16941
2021-11-13,15,8459,1450,3448,3569,120,54,17100
2021-11-13,16,8468,1395,3754,3429,70,80,17196
2021-11-13,17,8469,1226,4066,3461,8,132,17362
2021-11-13,18,8459,887,4371,3508,0,111,17336
2021-11-13,19,8461,892,4333,3409,0,70,17165
2021-11-13,20,8458,988,4039,3390,0,70,16945
2021-11-13,21,8454,530,3631,3192,0,84,15891
2021-11-13,22,8449,451,3354,3113,0,74,15441
2021-11-13,23,8458,486,3235,2970,0,59,15208
2021-11-13,24,8457,491,3098,2747,0,65,14858
2021-11-14,1,8466,491,3177,2489,0,58,14681
2021-11-14,2,8459,391,3320,2387,0,53,14610
2021-11-14,3,8464,234,3060,2436,0,61,14255
2021-11-14,4,8464,297,3077,2268,0,49,14155
2021-11-14,5,8464,648,3097,2156,0,49,14414
2021-11-14,6,8468,1206,3365,1872,0,50,14961
2021-11-14,7,8471,1888,3333,1774,1,49,15516
2021-11-14,8,8470,2063,3421,1549,5,49,15557
2021-11-14,9,8466,2310,3656,1585,21,50,16088
2021-11-14,10,8464,2311,3783,1774,57,49,16438
2021-11-14,11,8465,2281,3763,1938,88,49,16584
2021-11-14,12,8460,2049,3868,1750,67,49,16243
2021-11-14,13,8452,2035,3954,1592,57,50,16140
2021-11-14,14,8456,2863,3907,1301,31,49,16607
2021-11-14,15,8458,3257,3941,1169,25,49,16899
2021-11-14,16,8460,3273,4113,1105,8,49,17008
2021-11-14,17,8458,3989,4783,972,1,49,18252
2021-11-14,18,8455,4316,4818,873,0,49,18511
2021-11-14,19,8455,3980,4803,855,0,49,18142
2021-11-14,20,8452,3613,4651,775,0,49,17540
2021-11-14,21,8453,3945,4037,529,0,49,17013
2021-11-14,22,8448,3374,3346,451,0,52,15671
2021-11-14,23,8445,2923,3184,487,0,51,15090
2021-11-14,24,8448,2287,3013,737,0,68,14553
2021-11-15,1,8446,1191,2868,1066,0,67,13638
2021-11-15,2,8450,739,2785,1509,0,62,13545
2021-11-15,3,8453,890,2795,1749,0,57,13944
2021-11-15,4,8454,1222,2741,1903,0,67,14387
2021-11-15,5,8457,1628,2697,1946,0,103,14831
2021-11-15,6,8455,2094,2688,2031,0,89,15357
2021-11-15,7,8449,2500,2976,1954,0,80,15959
2021-11-15,8,8444,2734,3790,2082,3,85,17138
2021-11-15,9,8438,2837,3680,1985,24,137,17101
2021-11-15,10,8441,2828,3863,1869,57,145,17203
2021-11-15,11,8444,2595,3618,1677,102,169,16605
2021-11-15,12,8442,2163,3445,1977,125,207,16359
2021-11-15,13,8437,2249,3157,1783,168,147,15941
2021-11-15,14,8435,2643,3142,1835,134,160,16349
2021-11-15,15,8435,2862,3242,1728,71,116,16454
2021-11-15,16,8440,3160,3659,1438,35,86,16818
2021-11-15,17,8445,3535,4447,1686,11,92,18216
2021-11-15,18,8447,5083,4550,1615,0,75,19770
2021-11-15,19,8446,4094,4530,1408,0,76,18554
2021-11-15,20,8446,3199,4293,1459,0,74,17471
2021-11-15,21,8446,2761,4136,1290,0,92,16725
2021-11-15,22,8443,2313,3719,1262,0,83,15820
2021-11-15,23,8445,1787,3343,1333,0,76,14984
2021-11-15,24,8449,1531,2855,1165,0,84,14084
2021-11-16,1,8460,1540,2840,1282,0,65,14187
2021-11-16,2,8468,1559,2817,1364,0,73,14281
2021-11-16,3,8469,1650,2751,1533,0,59,14462
2021-11-16,4,8471,1844,2814,1247,0,59,14435
2021-11-16,5,8485,2023,2777,1038,0,59,14382
2021-11-16,6,8494,2320,3000,836,0,73,14723
2021-11-16,7,8489,2647,3380,711,1,99,15327
2021-11-16,8,8489,2914,4020,919,6,84,16432
2021-11-16,9,8331,3064,4068,828,56,102,16449
2021-11-16,10,8297,2845,3894,680,149,83,15948
2021-11-16,11,8300,2902,4067,556,151,88,16064
2021-11-16,12,8302,2939,3960,406,182,89,15878
2021-11-16,13,8303,3034,3952,416,203,102,16010
2021-11-16,14,8313,2996,3822,325,214,92,15762
2021-11-16,15,8333,3108,3994,242,158,80,15915
2021-11-16,16,8331,3373,4499,174,54,77,16508
2021-11-16,17,8314,4515,4762,156,7,81,17835
2021-11-16,18,8473,4820,4787,246,0,83,18409
2021-11-16,19,8493,4265,4855,347,0,74,18034
2021-11-16,20,8490,3434,4737,650,0,75,17386
2021-11-16,21,8497,2952,4374,1036,0,75,16934
2021-11-16,22,8506,2335,3782,1316,0,74,16013
2021-11-16,23,8505,2042,3079,1834,0,75,15535
2021-11-16,24,8519,1062,2893,1678,0,79,14231
2021-11-17,1,8524,516,2898,2198,0,70,14206
2021-11-17,2,8525,358,2675,2268,0,61,13887
2021-11-17,3,8529,206,2590,2478,0,80,13883
2021-11-17,4,8533,192,2610,2673,0,69,14077
2021-11-17,5,8532,308,2708,2804,0,60,14412
2021-11-17,6,8543,534,2802,2645,0,61,14585
2021-11-17,7,8544,599,3114,3203,1,72,15533
2021-11-17,8,8543,711,3824,3563,2,79,16722
2021-11-17,9,8538,804,3899,3566,12,79,16898
2021-11-17,10,8525,985,4474,3372,42,77,17475
2021-11-17,11,8528,1304,4662,3363,37,97,17991
2021-11-17,12,8540,1374,4409,3417,48,86,17874
2021-11-17,13,8535,1437,3951,3490,47,79,17539
2021-11-17,14,8379,1253,3723,3565,27,73,17020
2021-11-17,15,8351,1369,3637,3671,13,115,17156
2021-11-17,16,8365,1448,3744,4003,5,89,17654
2021-11-17,17,8371,1558,3905,4074,0,65,17973
2021-11-17,18,8527,1646,4213,4091,0,66,18543
2021-11-17,19,8563,1543,4200,4155,0,68,18529
2021-11-17,20,8560,1357,3864,4122,0,93,17996
2021-11-17,21,8556,797,3444,3934,0,101,16832
2021-11-17,22,8555,665,3273,3603,0,101,16197
2021-11-17,23,8561,198,2970,3635,0,111,15475
2021-11-17,24,8561,158,2908,3486,0,101,15214
2021-11-18,1,8563,149,3000,3146,0,98,14956
2021-11-18,2,8566,206,2949,2774,0,99,14594
2021-11-18,3,8570,215,2791,2396,0,97,14069
2021-11-18,4,8570,345,2674,2390,0,98,14077
2021-11-18,5,8567,472,2660,2232,0,100,14031
2021-11-18,6,8566,688,3083,2141,0,97,14575
2021-11-18,7,8562,956,3258,2216,0,106,15098
2021-11-18,8,8557,1391,3584,2308,1,107,15948
2021-11-18,9,8558,1506,3705,2793,12,107,16681
2021-11-18,10,8560,1715,3999,2734,38,98,17144
2021-11-18,11,8563,2159,3876,2996,58,103,17755
2021-11-18,12,8558,2107,3524,3197,116,95,17597
2021-11-18,13,8561,1905,3447,2946,90,84,17033
2021-11-18,14,8564,1701,3525,3669,85,86,17630
2021-11-18,15,8561,1624,3385,3672,60,87,17389
2021-11-18,16,8552,1737,3532,3101,40,88,17050
2021-11-18,17,8552,1435,3696,3570,4,89,17346
2021-11-18,18,8550,1445,4164,4141,0,95,18395
2021-11-18,19,8548,1313,4046,4130,0,98,18135
2021-11-18,20,8546,1227,3630,4132,0,97,17632
2021-11-18,21,8548,895,3700,3925,0,100,17168
2021-11-18,22,8544,685,3260,3822,0,89,16400
2021-11-18,23,8550,397,2905,3885,0,95,15832
2021-11-18,24,8549,157,2961,3853,0,78,15598
2021-11-19,1,8554,130,2969,3806,0,73,15532
2021-11-19,2,8553,129,3067,3692,0,71,15512
2021-11-19,3,8558,157,3035,3510,0,68,15328
2021-11-19,4,8555,184,3019,3451,0,60,15269
2021-11-19,5,8552,420,2817,3400,0,60,15249
2021-11-19,6,8550,628,2906,3058,0,58,15200
2021-11-19,7,8550,981,3365,3013,1,70,15980
2021-11-19,8,8547,1198,4129,2843,9,87,16813
2021-11-19,9,8545,1248,4082,2880,89,115,16959
2021-11-19,10,8546,997,4080,2789,205,95,16712
2021-11-19,11,8540,902,3940,2691,223,77,16373
2021-11-19,12,8539,1370,3955,2401,253,78,16596
2021-11-19,13,8539,1888,3834,1986,194,78,16519
2021-11-19,14,8536,2372,3794,1649,187,78,16616
2021-11-19,15,8536,2360,3780,1306,163,78,16223
2021-11-19,16,8535,2876,4184,982,81,73,16731
2021-11-19,17,8528,3643,4485,754,15,73,17498
2021-11-19,18,8526,4201,4688,702,0,73,18190
2021-11-19,19,8526,3982,4580,630,0,73,17791
2021-11-19,20,8526,3424,4527,739,0,73,17289
2021-11-19,21,8526,3077,4402,854,0,74,16933
2021-11-19,22,8515,2695,3964,935,0,73,16182
2021-11-19,23,8532,2147,3539,995,0,73,15286
2021-11-19,24,8528,859,3116,1294,0,62,13859
2021-11-20,1,8529,382,2921,1587,0,54,13473
2021-11-20,2,8536,323,2854,1641,0,47,13401
2021-11-20,3,8539,328,2903,1740,0,47,13557
2021-11-20,4,8542,442,3063,1886,0,46,13979
2021-11-20,5,8542,630,2933,2146,0,46,14297
2021-11-20,6,8544,883,2957,2482,0,47,14913
2021-11-20,7,8547,1324,2913,2634,1,46,15465
2021-11-20,8,8546,1406,3344,2609,5,46,15956
2021-11-20,9,8543,1583,3524,2677,27,46,16400
2021-11-20,10,8540,1707,3772,2874,53,47,16993
2021-11-20,11,8542,1801,3623,2965,92,46,17069
2021-11-20,12,8539,2133,3338,2781,120,47,16958
2021-11-20,13,8542,2342,3376,2460,114,46,16880
2021-11-20,14,8550,2632,3384,2310,86,46,17008
2021-11-20,15,8553,2846,3504,2047,39,46,17035
2021-11-20,16,8547,2635,3777,1619,18,47,16643
2021-11-20,17,8544,2638,4225,1648,2,46,17103
2021-11-20,18,8535,2747,4472,1926,0,46,17726
2021-11-20,19,8536,2227,4055,2182,0,47,17047
2021-11-20,20,8537,1644,3798,2433,0,46,16458
2021-11-20,21,8535,1379,3576,2411,0,46,15947
2021-11-20,22,8533,970,3547,2173,0,46,15269
2021-11-20,23,8549,654,3597,1778,0,46,14624
2021-11-20,24,8554,612,3591,1076,0,46,13879
2021-11-21,1,8552,389,3535,740,0,46,13262
2021-11-21,2,8552,287,3617,569,0,47,13072
2021-11-21,3,8553,447,3201,305,0,47,12553
2021-11-21,4,8555,1019,3111,163,0,46,12894
2021-11-21,5,8549,1023,2918,172,0,46,12708
2021-11-21,6,8549,937,2855,288,0,46,12675
2021-11-21,7,8551,1125,3175,438,0,47,13336
2021-11-21,8,8564,1161,3421,580,7,47,13780
2021-11-21,9,8570,1185,3778,863,60,47,14503
2021-11-21,10,8565,1135,3692,1192,142,46,14772
2021-11-21,11,8566,1309,3506,1406,154,46,14987
2021-11-21,12,8563,1051,3276,1814,143,47,14894
2021-11-21,13,8563,1001,3546,2415,142,46,15713
2021-11-21,14,8563,1191,3242,2432,97,46,15571
2021-11-21,15,8567,1493,3321,2743,31,46,16201
2021-11-21,16,8568,1704,3491,2937,11,47,16758
2021-11-21,17,8564,1950,3906,3142,1,46,17609
2021-11-21,18,8558,1939,3920,3589,0,46,18052
2021-11-21,19,8568,1932,3713,3762,0,46,18021
2021-11-21,20,8570,1928,3375,4106,0,46,18025
2021-11-21,21,8568,1267,3108,4435,0,46,17424
2021-11-21,22,8565,860,3032,4401,0,46,16904
2021-11-21,23,8566,186,3030,4394,0,47,16223
2021-11-21,24,8559,132,2843,4317,0,47,15898
2021-11-22,1,8564,133,2841,4002,0,48,15588
2021-11-22,2,8567,137,2834,3649,0,57,15244
2021-11-22,3,8580,147,2843,3689,0,59,15318
2021-11-22,4,8582,305,2725,3997,0,59,15668
2021-11-22,5,8580,561,2830,3415,0,60,15446
2021-11-22,6,8587,963,3040,3480,0,61,16131
2021-11-22,7,8580,1339,3353,3396,1,72,16741
2021-11-22,8,8583,1346,3921,3155,7,75,17087
2021-11-22,9,8580,1500,4011,2915,75,75,17156
2021-11-22,10,8576,1493,3720,2982,198,75,17044
2021-11-22,11,8576,1538,3715,3444,256,75,17604
2021-11-22,12,8575,1152,3313,3643,230,75,16988
2021-11-22,13,8572,1605,3028,3685,221,75,17186
2021-11-22,14,8574,1880,3200,3730,199,75,17658
2021-11-22,15,8571,2180,3351,3343,128,75,17648
2021-11-22,16,8570,2029,3915,2945,94,75,17628
2021-11-22,17,8572,2546,4397,2593,14,75,18197
2021-11-22,18,8574,3422,4819,2267,0,75,19157
2021-11-22,19,8574,3204,4272,2059,0,75,18184
2021-11-22,20,8573,2918,4232,2266,0,74,18063
2021-11-22,21,8572,2757,3947,2480,0,73,17829
2021-11-22,22,8575,2685,3439,2473,0,75,17247
2021-11-22,23,8576,2263,3053,2360,0,73,16325
2021-11-22,24,8579,1841,3086,2180,0,64,15750
2021-11-23,1,8582,1764,3086,2051,0,60,15543
2021-11-23,2,8583,1794,3157,1707,0,58,15299
2021-11-23,3,8598,1908,3073,1617,0,58,15254
2021-11-23,4,8597,1924,2933,1535,0,58,15047
2021-11-23,5,8593,2014,3024,1449,0,58,15138
2021-11-23,6,8595,2345,3083,1148,0,61,15232
2021-11-23,7,8598,3234,4098,1135,1,70,17136
2021-11-23,8,8602,4802,4544,964,8,74,18994
2021-11-23,9,8598,5102,4384,783,84,66,19017
2021-11-23,10,8595,4498,4225,576,208,61,18163
2021-11-23,11,8593,3782,4053,457,268,71,17224
2021-11-23,12,8588,3325,3901,499,262,74,16649
2021-11-23,13,8586,3084,3874,617,250,74,16485
2021-11-23,14,8586,3029,3766,610,229,75,16295
2021-11-23,15,8585,3345,4020,404,155,75,16584
2021-11-23,16,8590,3776,4214,330,66,74,17050
2021-11-23,17,8595,4822,4513,395,9,74,18408
2021-11-23,18,8592,5338,4560,592,0,75,19157
2021-11-23,19,8593,4913,4532,867,0,74,18979
2021-11-23,20,8591,4477,4219,1155,0,73,18515
2021-11-23,21,8586,3990,3740,1452,0,73,17841
2021-11-23,22,8585,3194,3520,1713,0,74,17086
2021-11-23,23,8585,2276,3068,1766,0,73,15768
2021-11-23,24,8591,1410,3147,2084,0,63,15295
2021-11-24,1,8589,890,2920,2345,0,59,14803
2021-11-24,2,8594,753,2773,2506,0,59,14685
2021-11-24,3,8600,704,2957,2432,0,58,14751
2021-11-24,4,8600,780,2930,2712,0,57,15079
2021-11-24,5,8598,1133,2884,2455,0,58,15128
2021-11-24,6,8601,1582,2857,2396,0,62,15498
2021-11-24,7,8621,1887,3212,3492,1,71,17284
2021-11-24,8,8620,2279,3900,3821,6,74,18700
2021-11-24,9,8617,2247,3963,3842,75,74,18818
2021-11-24,10,8612,1496,3711,3612,168,74,17673
2021-11-24,11,8615,1605,3744,3616,217,74,17871
2021-11-24,12,8614,1746,3738,3662,233,74,18067
2021-11-24,13,8616,1524,3758,3720,226,73,17917
2021-11-24,14,8614,1392,3803,3848,202,73,17932
2021-11-24,15,8612,1690,4174,3358,115,73,18022
2021-11-24,16,8605,1462,3926,3573,41,74,17681
2021-11-24,17,8608,1547,4031,3530,6,72,17794
2021-11-24,18,8610,1736,4619,3945,0,74,18984
2021-11-24,19,8607,1416,4199,3993,0,74,18289
2021-11-24,20,8608,800,4035,3986,0,74,17503
2021-11-24,21,8608,660,3750,3955,0,74,17047
2021-11-24,22,8606,404,3599,3879,0,74,16562
2021-11-24,23,8603,186,3306,3716,0,73,15884
2021-11-24,24,8605,159,3161,3476,0,63,15464
2021-11-25,1,8608,200,3141,3429,0,58,15436
2021-11-25,2,8604,171,3048,3417,0,57,15297
2021-11-25,3,8613,164,3074,3333,0,56,15240
2021-11-25,4,8615,398,2991,3068,0,56,15128
2021-11-25,5,8615,927,3018,2561,0,56,15177
2021-11-25,6,8614,1504,3095,2192,0,58,15463
2021-11-25,7,8611,2105,3452,1808,0,70,16046
2021-11-25,8,8607,2279,4109,1506,0,73,16574
2021-11-25,9,8605,2653,4275,1314,3,73,16923
2021-11-25,10,8604,2647,4164,1331,11,73,16830
2021-11-25,11,8605,2895,4340,1195,17,74,17126
2021-11-25,12,8604,3272,4441,1058,17,74,17466
2021-11-25,13,8601,3404,4316,1067,13,73,17474
2021-11-25,14,8600,3270,4273,1082,10,74,17309
2021-11-25,15,8596,3226,4181,1153,5,74,17235
2021-11-25,16,8602,3148,4405,1209,0,74,17438
2021-11-25,17,8609,3127,5001,1033,0,74,17844
2021-11-25,18,8607,2926,5268,1058,0,74,17933
2021-11-25,19,8607,2455,4787,1748,0,74,17671
2021-11-25,20,8613,1690,4575,2213,0,74,17165
2021-11-25,21,8608,1426,3498,2826,0,74,16432
2021-11-25,22,8610,634,3255,3050,0,74,15623
2021-11-25,23,8618,193,3205,3298,0,74,15388
2021-11-25,24,8617,156,3052,3299,0,64,15188
2021-11-26,1,8618,156,2893,3348,0,58,15073
2021-11-26,2,8623,155,2847,3510,0,57,15192
2021-11-26,3,8626,168,2833,3677,0,57,15361
2021-11-26,4,8628,183,3010,3700,0,57,15578
2021-11-26,5,8624,218,2951,3734,0,57,15584
2021-11-26,6,8564,270,3064,3555,0,60,15513
2021-11-26,7,8551,519,3434,3468,1,69,16042
2021-11-26,8,8550,530,3716,3711,2,74,16583
2021-11-26,9,8547,544,3804,3692,21,74,16682
2021-11-26,10,8542,225,4136,3722,31,74,16730
2021-11-26,11,8546,481,4015,3778,38,74,16932
2021-11-26,12,8542,615,4116,3565,45,74,16957
2021-11-26,13,8538,848,4170,3610,48,74,17288
2021-11-26,14,8545,1328,4076,3327,42,75,17393
2021-11-26,15,8550,1375,4086,3503,51,45,17610
2021-11-26,16,8551,1428,4193,3535,21,27,17755
2021-11-26,17,8549,1730,4578,3036,1,50,17944
2021-11-26,18,8572,1745,5370,2966,0,75,18728
2021-11-26,19,8610,1743,5177,2745,0,75,18350
2021-11-26,20,8613,1755,5004,2424,0,75,17871
2021-11-26,21,8609,2223,4713,2096,0,75,17716
2021-11-26,22,8606,2186,3973,1808,0,74,16647
2021-11-26,23,8614,1863,3558,1602,0,74,15711
2021-11-26,24,8615,1144,3433,1530,0,60,14782
2021-11-27,1,8620,806,3345,1459,0,48,14278
2021-11-27,2,8619,855,3408,1343,0,47,14272
2021-11-27,3,8623,997,3400,1161,0,48,14229
2021-11-27,4,8620,1119,3358,967,0,47,14111
2021-11-27,5,8622,1374,3376,894,0,48,14314
2021-11-27,6,8621,1662,3459,800,0,47,14589
2021-11-27,7,8622,1793,3980,659,1,47,15102
2021-11-27,8,8618,2082,4300,538,7,47,15592
2021-11-27,9,8613,2218,4387,532,55,49,15854
2021-11-27,10,8610,2783,4169,422,130,47,16161
2021-11-27,11,8615,2836,3983,309,210,47,16000
2021-11-27,12,8615,3350,3884,311,267,47,16474
2021-11-27,13,8614,2855,3871,493,290,47,16170
2021-11-27,14,8607,2576,3855,545,245,48,15876
2021-11-27,15,8606,2456,3902,451,156,47,15618
2021-11-27,16,8610,2799,4345,283,51,47,16135
2021-11-27,17,8617,3700,4841,281,4,47,17490
2021-11-27,18,8616,3958,5011,386,0,47,18018
2021-11-27,19,8614,3654,5012,539,0,47,17866
2021-11-27,20,8619,3474,4897,552,0,47,17589
2021-11-27,21,8616,3131,4478,469,0,47,16741
2021-11-27,22,8617,3030,4417,381,0,47,16492
2021-11-27,23,8621,2892,3874,292,0,48,15727
2021-11-27,24,8622,2478,3571,268,0,47,14986
2021-11-28,1,8621,1416,3381,272,0,47,13737
2021-11-28,2,8622,1201,3314,310,0,48,13495
2021-11-28,3,8624,1466,3295,336,0,47,13768
2021-11-28,4,8628,1708,3456,336,0,47,14175
2021-11-28,5,8626,1843,3315,353,0,48,14185
2021-11-28,6,8621,1884,3341,465,0,47,14358
2021-11-28,7,8619,1935,3414,525,1,47,14541
2021-11-28,8,8620,2038,3617,699,1,48,15023
2021-11-28,9,8628,2699,4197,643,6,48,16221
2021-11-28,10,8624,3121,4346,710,26,47,16874
2021-11-28,11,8623,3278,4113,966,37,48,17065
2021-11-28,12,8621,3030,4073,1211,27,47,17009
2021-11-28,13,8619,2729,4011,1360,38,47,16804
2021-11-28,14,8618,2588,4122,1508,31,48,16915
2021-11-28,15,8620,2576,4192,1582,21,47,17038
2021-11-28,16,8621,2413,4189,1532,7,47,16809
2021-11-28,17,8619,2513,4365,1239,1,48,16785
2021-11-28,18,8620,2714,4852,2042,1,48,18277
2021-11-28,19,8621,2818,4982,1991,0,48,18460
2021-11-28,20,8621,2872,4812,1860,0,48,18213
2021-11-28,21,8619,3058,4166,1687,0,47,17577
2021-11-28,22,8619,3040,3867,1574,0,47,17147
2021-11-28,23,8616,2768,3405,1488,0,47,16324
2021-11-28,24,8619,2557,3036,1195,0,48,15455
2021-11-29,1,8622,2486,3231,1044,0,48,15431
2021-11-29,2,8623,2647,3165,884,0,54,15373
2021-11-29,3,8622,2528,3073,855,0,62,15140
2021-11-29,4,8617,2659,2867,776,0,62,14981
2021-11-29,5,8620,2997,2869,730,0,62,15278
2021-11-29,6,8619,3169,3160,820,0,62,15830
2021-11-29,7,8619,3729,3902,638,0,68,16956
2021-11-29,8,8620,4953,4241,578,2,75,18469
2021-11-29,9,8611,4879,4001,592,8,75,18166
2021-11-29,10,8612,5079,4064,459,21,75,18310
2021-11-29,11,8603,4861,3670,402,50,73,17659
2021-11-29,12,8600,4966,3452,378,81,74,17551
2021-11-29,13,8589,4952,3518,421,137,74,17691
2021-11-29,14,8588,4729,3558,549,153,74,17651
2021-11-29,15,8584,4794,3578,651,112,74,17793
2021-11-29,16,8592,4831,4146,601,38,73,18281
2021-11-29,17,8593,5149,4828,473,4,75,19122
2021-11-29,18,8591,5592,5028,461,0,74,19746
2021-11-29,19,8591,4945,4969,648,0,74,19227
2021-11-29,20,8589,4684,4567,681,0,74,18595
2021-11-29,21,8587,4750,3872,661,0,74,17944
2021-11-29,22,8596,4497,3489,910,0,74,17566
2021-11-29,23,8580,3367,3256,1052,0,74,16329
2021-11-29,24,8597,2856,3062,821,0,66,15402
2021-11-30,1,8601,2734,3009,916,0,59,15319
2021-11-30,2,8603,2508,2843,907,0,59,14920
2021-11-30,3,8607,2498,2852,791,0,60,14808
2021-11-30,4,8603,2534,2998,683,0,59,14877
2021-11-30,5,8601,2525,2707,684,0,59,14576
2021-11-30,6,8598,2668,2980,601,0,62,14909
2021-11-30,7,8602,3169,3734,519,1,69,16094
2021-11-30,8,8600,4648,4266,404,2,75,17995
2021-11-30,9,8600,5287,4227,422,11,73,18620
2021-11-30,10,8599,4686,4080,484,32,75,17956
2021-11-30,11,8598,4700,4041,554,52,74,18019
2021-11-30,12,8609,4702,3629,696,79,73,17788
2021-11-30,13,8596,4553,3424,891,77,73,17614
2021-11-30,14,8589,4435,3316,1222,51,74,17687
2021-11-30,15,8590,3655,3322,2167,25,75,17834
2021-11-30,16,8589,2890,3639,2967,17,73,18175
2021-11-30,17,8586,2785,4177,3321,1,73,18943
2021-11-30,18,8586,3021,4400,3558,0,74,19639
2021-11-30,19,8587,2371,4320,3592,0,78,18948
2021-11-30,20,8584,2061,4191,3540,0,76,18452
2021-11-30,21,8579,2105,3669,3578,0,74,18005
2021-11-30,22,8582,2124,3186,3518,0,74,17484
2021-11-30,23,8582,1685,2843,3381,0,76,16567
2021-11-30,24,8582,1346,2769,3247,0,70,16014
2021-12-01,1,8583,1705,2755,3000,0,59,16102
2021-12-01,2,8587,1923,2894,2563,0,58,16025
2021-12-01,3,8587,2097,3058,1924,0,58,15724
2021-12-01,4,8590,2618,2983,1485,0,59,15735
2021-12-01,5,8589,2527,3006,1094,0,60,15276
2021-12-01,6,8600,2725,2926,735,0,70,15056
2021-12-01,7,8596,3335,3623,709,1,88,16352
2021-12-01,8,8594,4653,3972,722,3,103,18047
2021-12-01,9,8593,4974,3973,721,23,103,18387
2021-12-01,10,8596,5033,3927,753,55,102,18466
2021-12-01,11,8600,5095,3519,833,92,95,18234
2021-12-01,12,8602,4773,3368,1065,141,88,18037
2021-12-01,13,8608,4113,3358,1243,85,88,17495
2021-12-01,14,8607,3959,3503,1276,71,89,17505
2021-12-01,15,8630,4117,3643,1273,38,88,17789
2021-12-01,16,8624,4524,4006,1054,12,83,18303
2021-12-01,17,8625,4804,4241,1229,2,78,18979
2021-12-01,18,8629,4513,4185,1889,0,70,19286
2021-12-01,19,8634,3926,4192,2717,0,63,19532
2021-12-01,20,8630,3361,3783,3361,0,73,19208
2021-12-01,21,8631,2805,3625,3396,0,75,18532
2021-12-01,22,8631,2101,3142,3475,0,73,17422
2021-12-01,23,8631,1404,3044,3693,0,73,16845
2021-12-01,24,8631,660,2728,3781,0,65,15865
2021-12-02,1,8634,210,2654,3652,0,59,15209
2021-12-02,2,8641,135,2613,3935,0,59,15383
2021-12-02,3,8644,144,2586,4235,0,59,15668
2021-12-02,4,8647,223,2638,4034,0,59,15601
2021-12-02,5,8644,576,2684,3825,0,59,15788
2021-12-02,6,8640,1144,2654,3789,0,60,16287
2021-12-02,7,8643,1550,2791,4153,0,65,17202
2021-12-02,8,8643,1630,3492,4586,1,74,18426
2021-12-02,9,8634,1630,3649,4532,7,73,18525
2021-12-02,10,8634,1789,3679,4473,29,73,18677
2021-12-02,11,8634,1986,3359,4385,129,73,18566
2021-12-02,12,8631,2010,3304,4389,106,73,18513
2021-12-02,13,8632,2052,3083,4384,61,74,18286
2021-12-02,14,8629,2163,3152,4129,92,74,18239
2021-12-02,15,8620,2215,3155,4157,39,77,18263
2021-12-02,16,8618,2068,3217,4055,31,76,18065
2021-12-02,17,8624,1577,3592,4197,3,79,18072
2021-12-02,18,8625,1732,4275,4295,0,79,19006
2021-12-02,19,8624,1943,4100,3998,0,76,18741
2021-12-02,20,8624,1842,3871,3877,0,74,18288
2021-12-02,21,8619,2014,3378,3785,0,74,17870
2021-12-02,22,8624,1881,3295,3248,0,74,17122
2021-12-02,23,8622,1991,3297,2737,0,73,16720
2021-12-02,24,8633,1491,3242,2341,0,65,15772
2021-12-03,1,8635,1627,3350,2045,0,59,15716
2021-12-03,2,8640,1954,3405,1727,0,58,15784
2021-12-03,3,8636,2410,3012,1513,0,58,15629
2021-12-03,4,8636,2153,3016,1447,0,59,15311
2021-12-03,5,8638,2193,2982,1392,0,58,15263
2021-12-03,6,8628,2431,2801,1339,0,60,15259
2021-12-03,7,8630,2821,3350,924,0,69,15794
2021-12-03,8,8622,3469,4173,1016,2,74,17356
2021-12-03,9,8624,3834,4219,689,24,74,17464
2021-12-03,10,8619,4134,4060,427,94,77,17411
2021-12-03,11,8615,4051,3950,325,174,91,17206
2021-12-03,12,8613,4144,3781,265,211,92,17106
2021-12-03,13,8611,4105,3749,280,210,88,17043
2021-12-03,14,8617,4154,3725,288,190,91,17065
2021-12-03,15,8619,4331,3813,226,123,95,17207
2021-12-03,16,8619,4576,4188,218,52,93,17746
2021-12-03,17,8618,5246,4774,193,4,96,18931
2021-12-03,18,8617,5470,5133,228,0,93,19541
2021-12-03,19,8618,4970,5083,219,0,85,18975
2021-12-03,20,8619,5041,5011,271,0,78,19020
2021-12-03,21,8616,4852,4406,268,0,74,18216
2021-12-03,22,8621,4732,3956,250,0,75,17634
2021-12-03,23,8618,3957,3590,231,0,75,16471
2021-12-03,24,8617,3101,3294,261,0,61,15334
2021-12-04,1,8617,2552,3092,383,0,47,14691
2021-12-04,2,8621,2388,3009,685,0,47,14750
2021-12-04,3,8628,2270,3008,1013,0,47,14966
2021-12-04,4,8631,2166,3007,1378,0,48,15230
2021-12-04,5,8634,2160,3071,1716,0,47,15628
2021-12-04,6,8631,1926,3200,2211,0,56,16024
2021-12-04,7,8634,1862,3304,2625,1,58,16484
2021-12-04,8,8629,1575,3522,3074,1,65,16866
2021-12-04,9,8636,1553,3747,3352,19,70,17377
2021-12-04,10,8631,1699,3650,3650,81,69,17780
2021-12-04,11,8627,2088,3715,3882,138,58,18508
2021-12-04,12,8628,2170,3188,3960,253,50,18249
2021-12-04,13,8628,2224,3280,4036,196,58,18422
2021-12-04,14,8627,2181,3197,4001,164,53,18223
2021-12-04,15,8625,2366,3240,3761,114,62,18168
2021-12-04,16,8622,2665,3503,3280,55,55,18180
2021-12-04,17,8623,3661,4346,2769,10,53,19462
2021-12-04,18,8624,4444,4545,2684,0,54,20351
2021-12-04,19,8628,4163,4496,2690,0,55,20032
2021-12-04,20,8624,3866,3885,2746,0,55,19176
2021-12-04,21,8629,3663,3724,2717,0,52,18785
2021-12-04,22,8632,3062,3452,2533,0,47,17726
2021-12-04,23,8630,2724,3216,2387,0,50,17007
2021-12-04,24,8629,2070,3046,2277,0,53,16075
2021-12-05,1,8628,1977,3157,1775,0,53,15590
2021-12-05,2,8635,2399,3039,1333,0,54,15460
2021-12-05,3,8633,2384,3005,1002,0,49,15073
2021-12-05,4,8627,2231,3072,668,0,50,14648
2021-12-05,5,8628,2660,3039,376,0,48,14751
2021-12-05,6,8627,2878,3102,185,0,47,14839
2021-12-05,7,8625,2579,3579,108,0,47,14938
2021-12-05,8,8626,3501,3803,149,1,47,16127
2021-12-05,9,8620,3825,3817,325,20,47,16654
2021-12-05,10,8615,3777,3842,507,70,47,16858
2021-12-05,11,8609,3607,3846,626,120,47,16855
2021-12-05,12,8608,2920,3569,1061,122,48,16328
2021-12-05,13,8611,2883,3270,2022,101,48,16935
2021-12-05,14,8609,2555,3164,2311,86,47,16772
2021-12-05,15,8608,2831,3361,2560,65,47,17472
2021-12-05,16,8602,2538,3349,3112,12,48,17661
2021-12-05,17,8608,2860,4084,3433,1,47,19033
2021-12-05,18,8600,3309,4270,3835,0,47,20061
2021-12-05,19,8599,3394,4227,3789,0,62,20071
2021-12-05,20,8590,2943,3768,3627,0,54,18982
2021-12-05,21,8591,2333,3997,2904,0,47,17872
2021-12-05,22,8599,2406,3428,2930,0,48,17411
2021-12-05,23,8599,1669,2719,3500,0,48,16535
2021-12-05,24,8596,705,2716,3676,0,47,15740
2021-12-06,1,8602,220,3024,3824,0,47,15717
2021-12-06,2,8606,203,3218,3642,0,56,15725
2021-12-06,3,8602,382,3418,3277,0,57,15736
2021-12-06,4,8609,704,3179,2939,0,57,15488
2021-12-06,5,8608,984,3332,2506,0,57,15487
2021-12-06,6,8606,1039,3102,2563,0,62,15372
2021-12-06,7,8601,1371,3110,2790,0,68,15940
2021-12-06,8,8598,1398,3249,3663,0,74,16982
2021-12-06,9,8597,1408,3358,4064,2,79,17508
2021-12-06,10,8596,1590,3929,4189,4,81,18389
2021-12-06,11,8595,1798,4037,4348,13,80,18871
2021-12-06,12,8594,2050,4136,4416,21,81,19298
2021-12-06,13,8589,2123,3672,4478,41,73,18976
2021-12-06,14,8582,1799,3403,4525,33,73,18415
2021-12-06,15,8580,1764,3323,4486,46,73,18272
2021-12-06,16,8576,1768,3641,4500,15,73,18573
2021-12-06,17,8578,1791,4131,4486,3,74,19063
2021-12-06,18,8578,2204,4463,4469,0,74,19788
2021-12-06,19,8577,2124,4337,4467,0,74,19579
2021-12-06,20,8575,2149,4184,4413,0,73,19394
2021-12-06,21,8575,2307,3805,4337,0,73,19097
2021-12-06,22,8572,2018,3613,4067,0,73,18343
2021-12-06,23,8565,2089,3391,3851,0,73,17969
2021-12-06,24,8558,1312,3242,3551,0,63,16726
2021-12-07,1,8556,1143,3282,3283,0,59,16323
2021-12-07,2,8561,1223,3257,3361,0,60,16462
2021-12-07,3,8562,1032,2979,3464,0,60,16097
2021-12-07,4,8562,1172,3139,3183,0,59,16115
2021-12-07,5,8473,1524,3191,3060,0,59,16307
2021-12-07,6,8465,2185,3264,2618,0,61,16593
2021-12-07,7,8460,2667,3594,2262,1,69,17053
2021-12-07,8,8437,4099,3942,1805,2,73,18358
2021-12-07,9,8434,4365,3994,1558,29,73,18453
2021-12-07,10,8435,4769,4410,1153,58,74,18899
2021-12-07,11,8434,4991,4378,842,98,74,18817
2021-12-07,12,8435,5210,4214,830,122,74,18885
2021-12-07,13,8436,5208,4105,797,150,74,18770
2021-12-07,14,8436,4904,4030,722,127,74,18293
2021-12-07,15,8521,4709,4184,802,88,74,18378
2021-12-07,16,8528,4897,4283,947,34,74,18763
2021-12-07,17,8546,5426,4922,792,3,73,19762
2021-12-07,18,8539,5877,5566,575,0,74,20631
2021-12-07,19,8542,5735,5519,523,0,73,20392
2021-12-07,20,8544,5494,5367,587,0,73,20065
2021-12-07,21,8539,5438,4923,604,0,73,19577
2021-12-07,22,8534,5479,4389,546,0,73,19021
2021-12-07,23,8537,5216,3951,437,0,73,18214
2021-12-07,24,8535,4268,3743,323,0,64,16933
2021-12-08,1,8535,4244,3585,210,0,60,16634
2021-12-08,2,8532,3713,3534,168,0,59,16006
2021-12-08,3,8540,4054,3436,191,0,59,16280
2021-12-08,4,8538,4422,3454,230,0,60,16704
2021-12-08,5,8537,4721,3375,400,0,60,17093
2021-12-08,6,8535,4305,3446,617,0,61,16964
2021-12-08,7,8534,5097,4082,674,0,68,18455
2021-12-08,8,8531,5903,4405,746,0,74,19659
2021-12-08,9,8524,5964,4629,735,3,74,19929
2021-12-08,10,8524,6093,4571,851,10,73,20122
2021-12-08,11,8525,6127,4635,881,14,73,20255
2021-12-08,12,8523,6241,4510,913,24,73,20284
2021-12-08,13,8519,6222,4319,762,50,73,19945
2021-12-08,14,8521,6246,4208,700,46,73,19794
2021-12-08,15,8522,6252,4085,783,26,73,19741
2021-12-08,16,8515,6346,3849,922,17,73,19722
2021-12-08,17,8515,6537,4155,999,1,74,20281
2021-12-08,18,8512,6292,5126,1098,0,78,21106
2021-12-08,19,8510,6399,5086,955,0,78,21028
2021-12-08,20,8509,6350,4814,1275,0,78,21026
2021-12-08,21,8509,5946,4401,1387,0,78,20321
2021-12-08,22,8502,5467,4158,1251,0,78,19456
2021-12-08,23,8501,4891,3804,924,0,78,18198
2021-12-08,24,8499,3873,3442,708,0,70,16592
2021-12-09,1,8522,3603,3342,571,0,65,16103
2021-12-09,2,8536,3651,3249,616,0,64,16116
2021-12-09,3,8549,3609,3279,514,0,63,16014
2021-12-09,4,8557,3369,3300,691,0,63,15980
2021-12-09,5,8557,3514,3380,674,0,63,16188
2021-12-09,6,8555,3631,3489,740,0,68,16483
2021-12-09,7,8555,4636,4134,695,0,73,18093
2021-12-09,8,8552,5057,4506,837,1,78,19031
2021-12-09,9,8553,4964,4600,1074,3,79,19273
2021-12-09,10,8555,5036,4516,904,15,79,19105
2021-12-09,11,8565,5148,4417,1179,24,79,19412
2021-12-09,12,8567,4616,4270,1388,25,78,18944
2021-12-09,13,8572,4494,4083,1473,29,79,18730
2021-12-09,14,8566,4932,3762,1529,26,79,18894
2021-12-09,15,8571,5156,3759,1920,10,79,19495
2021-12-09,16,8571,4301,4107,2579,6,79,19643
2021-12-09,17,8569,3768,4378,3304,2,79,20100
2021-12-09,18,8565,3808,4902,3570,0,79,20924
2021-12-09,19,8567,3763,4804,3667,0,79,20880
2021-12-09,20,8559,4194,4631,3578,0,79,21041
2021-12-09,21,8565,4494,3966,3401,0,79,20505
2021-12-09,22,8555,4116,3583,3292,0,80,19626
2021-12-09,23,8575,2620,3464,3157,0,80,17896
2021-12-09,24,8583,2411,3209,2885,0,69,17157
2021-12-10,1,8584,2426,3168,2576,0,64,16818
2021-12-10,2,8583,2281,3097,2293,0,63,16317
2021-12-10,3,8577,2483,3067,1978,0,63,16168
2021-12-10,4,8581,2478,3052,1805,0,62,15978
2021-12-10,5,8581,2477,2762,2026,0,64,15910
2021-12-10,6,8583,2545,3165,1739,0,69,16101
2021-12-10,7,8582,3119,4045,1608,0,76,17430
2021-12-10,8,8583,3876,4309,1378,1,79,18226
2021-12-10,9,8597,3982,4434,1199,10,79,18301
2021-12-10,10,8595,3671,4680,1029,35,79,18089
2021-12-10,11,8599,4068,4597,837,75,79,18255
2021-12-10,12,8607,4211,4464,580,111,79,18052
2021-12-10,13,8603,4373,4240,379,167,79,17841
2021-12-10,14,8600,4651,4073,278,107,79,17788
2021-12-10,15,8594,4363,4581,120,73,79,17810
2021-12-10,16,8586,4288,4778,122,55,79,17908
2021-12-10,17,8603,4340,5237,256,5,79,18520
2021-12-10,18,8602,4504,5099,508,0,80,18793
2021-12-10,19,8631,3874,4814,1020,0,79,18418
2021-12-10,20,8625,3204,4290,1899,0,79,18097
2021-12-10,21,8624,2570,3382,2669,0,79,17324
2021-12-10,22,8624,2339,3186,2876,0,79,17104
2021-12-10,23,8629,1694,3202,3081,0,79,16685
2021-12-10,24,8628,845,3263,3455,0,64,16255
2021-12-11,1,8618,393,3033,3645,0,47,15736
2021-12-11,2,8624,196,3094,3813,0,47,15774
2021-12-11,3,8624,139,3117,3832,0,47,15759
2021-12-11,4,8623,140,3120,3924,0,47,15854
2021-12-11,5,8626,140,3086,3831,0,47,15730
2021-12-11,6,8630,140,3069,3871,0,47,15757
2021-12-11,7,8632,140,3112,3890,0,47,15821
2021-12-11,8,8631,149,3271,4208,1,47,16307
2021-12-11,9,8633,217,3546,4197,4,47,16644
2021-12-11,10,8632,367,3873,4209,28,47,17156
2021-12-11,11,8629,557,3762,4195,83,47,17273
2021-12-11,12,8628,822,3590,4038,132,47,17257
2021-12-11,13,8630,868,3962,3623,69,47,17199
2021-12-11,14,8633,1025,4008,3334,36,47,17083
2021-12-11,15,8629,1059,4023,3128,37,47,16923
2021-12-11,16,8630,933,3795,3033,28,47,16466
2021-12-11,17,8626,1212,4028,3150,0,47,17063
2021-12-11,18,8622,1213,4130,3483,0,9,17457
2021-12-11,19,8622,1273,4344,3551,0,0,17790
2021-12-11,20,8615,1231,3920,3647,0,0,17413
2021-12-11,21,8613,1211,3707,3864,0,0,17395
2021-12-11,22,8618,1213,3394,3922,0,1,17148
2021-12-11,23,8612,624,3519,3922,0,10,16687
2021-12-11,24,8612,206,3410,3786,0,41,16055
2021-12-12,1,8606,172,3261,3769,0,47,15855
2021-12-12,2,8611,140,3071,3701,0,47,15570
2021-12-12,3,8611,140,2729,3829,0,47,15356
2021-12-12,4,8610,140,2761,3729,0,47,15287
2021-12-12,5,8608,141,2942,3442,0,47,15180
2021-12-12,6,8606,181,3507,3076,0,47,15417
2021-12-12,7,8602,230,3782,2973,0,47,15634
2021-12-12,8,8602,262,4095,3020,0,47,16026
2021-12-12,9,8600,230,3827,3181,32,47,15917
2021-12-12,10,8597,222,3215,3429,107,47,15617
2021-12-12,11,8593,298,3310,3509,188,47,15945
2021-12-12,12,8594,449,3051,3644,211,47,15996
2021-12-12,13,8593,592,3050,3705,213,47,16200
2021-12-12,14,8588,643,3045,3289,219,47,15831
2021-12-12,15,8600,920,3139,3102,170,47,15978
2021-12-12,16,8606,937,3466,3896,82,47,17034
2021-12-12,17,8606,937,3959,4334,11,47,17894
2021-12-12,18,8603,1056,4670,4416,0,47,18792
2021-12-12,19,8609,1380,4575,4427,0,16,19007
2021-12-12,20,8615,1087,4430,4434,0,5,18571
2021-12-12,21,8616,961,4188,4483,0,1,18249
2021-12-12,22,8619,285,3891,4449,0,0,17244
2021-12-12,23,8616,158,3569,4438,0,0,16781
2021-12-12,24,8615,168,3045,4204,0,0,16032
2021-12-13,1,8617,170,2986,4049,0,3,15825
2021-12-13,2,8614,170,2955,4123,0,14,15876
2021-12-13,3,8614,171,2995,3931,0,16,15727
2021-12-13,4,8606,183,3098,3998,0,14,15899
2021-12-13,5,8606,291,3016,3743,0,14,15670
2021-12-13,6,8604,415,3142,3580,0,27,15768
2021-12-13,7,8610,592,3545,3910,0,68,16725
2021-12-13,8,8609,702,4318,4029,1,91,17750
2021-12-13,9,8609,767,4356,4088,34,95,17949
2021-12-13,10,8611,1007,4345,4028,114,89,18194
2021-12-13,11,8615,1019,3863,3960,196,144,17797
2021-12-13,12,8608,1371,3452,3705,266,177,17579
2021-12-13,13,8613,1123,3299,3891,272,183,17381
2021-12-13,14,8615,1154,3347,3835,252,202,17405
2021-12-13,15,8611,1632,3348,3215,188,202,17196
2021-12-13,16,8607,1974,3924,2534,89,206,17334
2021-12-13,17,8609,1975,4154,3017,12,205,17972
2021-12-13,18,8609,1967,4596,3433,1,204,18810
2021-12-13,19,8615,1790,4664,3377,0,194,18640
2021-12-13,20,8614,1769,4353,3065,0,156,17957
2021-12-13,21,8612,1453,4545,2655,0,84,17349
2021-12-13,22,8608,1728,4257,2090,0,87,16770
2021-12-13,23,8602,1480,3875,1700,0,87,15744
2021-12-13,24,8605,1303,3733,1427,0,95,15163
2021-12-14,1,8604,1365,3867,1094,0,81,15011
2021-12-14,2,8609,1666,3718,825,0,64,14882
2021-12-14,3,8606,1806,3629,756,0,66,14863
2021-12-14,4,8606,1911,3542,756,0,71,14886
2021-12-14,5,8609,2229,3474,800,0,82,15194
2021-12-14,6,8611,2245,3782,839,0,83,15560
2021-12-14,7,8609,2263,3995,910,1,104,15882
2021-12-14,8,8612,2492,4628,1001,1,116,16850
2021-12-14,9,8611,2451,4611,1036,34,116,16859
2021-12-14,10,8614,2334,4242,975,109,114,16388
2021-12-14,11,8617,2053,3932,817,181,115,15715
2021-12-14,12,8630,2079,3693,601,254,120,15377
2021-12-14,13,8619,2052,3651,648,271,123,15364
2021-12-14,14,8615,2214,3605,662,241,117,15454
2021-12-14,15,8616,2271,3526,946,157,115,15631
2021-12-14,16,8616,2248,4162,1119,50,104,16299
2021-12-14,17,8615,2241,4698,1415,10,99,17078
2021-12-14,18,8616,2806,5312,1941,0,95,18770
2021-12-14,19,8618,2203,5077,2473,0,84,18455
2021-12-14,20,8618,1980,4707,3106,0,49,18460
2021-12-14,21,8619,1622,3980,3343,0,34,17598
2021-12-14,22,8619,1260,3707,3350,0,36,16972
2021-12-14,23,8623,1103,3593,3178,0,33,16530
2021-12-14,24,8623,618,3476,3283,0,23,16023
2021-12-15,1,8620,286,3603,3048,0,16,15573
2021-12-15,2,8621,253,3490,2995,0,16,15375
2021-12-15,3,8619,255,3194,3128,0,16,15212
2021-12-15,4,8613,342,3104,3250,0,16,15325
2021-12-15,5,8615,815,2954,3135,0,16,15535
2021-12-15,6,8616,1362,3103,3114,0,19,16214
2021-12-15,7,8617,1793,3548,3180,1,26,17165
2021-12-15,8,8617,1813,4050,3222,1,31,17734
2021-12-15,9,8613,1884,4324,3346,3,32,18202
2021-12-15,10,8618,1969,4319,3619,15,32,18572
2021-12-15,11,8612,1985,4224,3797,21,32,18671
2021-12-15,12,8616,1994,4226,3945,23,33,18837
2021-12-15,13,8617,1717,4290,3824,32,36,18516
2021-12-15,14,8623,1852,4428,3736,24,40,18703
2021-12-15,15,8632,1863,4306,3663,21,40,18525
2021-12-15,16,8630,1522,4221,3718,12,32,18135
2021-12-15,17,8629,1504,4809,3675,1,32,18650
2021-12-15,18,8627,1912,4811,3691,0,32,19073
2021-12-15,19,8624,1606,4670,3805,0,33,18738
2021-12-15,20,8618,1478,4585,3912,0,33,18626
2021-12-15,21,8618,1262,4055,4030,0,33,17998
2021-12-15,22,8618,1524,3591,4119,0,33,17885
2021-12-15,23,8619,701,3400,4167,0,32,16919
2021-12-15,24,8621,227,3279,4190,0,24,16341
2021-12-16,1,8620,138,3250,4233,0,17,16258
2021-12-16,2,8623,137,3111,4272,0,17,16160
2021-12-16,3,8622,137,2932,4251,0,17,15959
2021-12-16,4,8623,137,2880,4159,0,17,15816
2021-12-16,5,8424,137,3167,4192,0,17,15937
2021-12-16,6,8205,138,3213,4240,0,20,15816
2021-12-16,7,8212,144,3658,4193,0,25,16232
2021-12-16,8,8210,258,4228,4100,1,31,16828
2021-12-16,9,8204,288,4133,3989,1,31,16646
2021-12-16,10,8208,497,4393,3815,18,32,16963
2021-12-16,11,8207,842,4335,3850,31,32,17297
2021-12-16,12,8209,925,4240,3936,29,32,17371
2021-12-16,13,8206,970,4093,4095,27,31,17422
2021-12-16,14,8204,1003,4177,4173,29,31,17617
2021-12-16,15,8203,1043,4211,4173,20,32,17682
2021-12-16,16,8199,991,4291,4304,16,32,17833
2021-12-16,17,8200,885,4142,4354,6,32,17619
2021-12-16,18,8204,887,4493,4279,0,32,17895
2021-12-16,19,8199,1129,4609,4178,0,32,18147
2021-12-16,20,8196,1141,4578,4218,0,33,18166
2021-12-16,21,8195,1217,4447,4166,0,33,18058
2021-12-16,22,8195,1258,4005,4127,0,33,17618
2021-12-16,23,8176,642,3625,4173,0,33,16649
2021-12-16,24,8183,217,3207,4302,0,26,15935
2021-12-17,1,8189,139,3033,4346,0,18,15725
2021-12-17,2,8187,150,2963,4336,0,17,15653
2021-12-17,3,8188,237,3099,4270,0,17,15811
2021-12-17,4,8185,377,3423,3813,0,17,15815
2021-12-17,5,8170,717,3355,3503,0,19,15764
2021-12-17,6,8174,1073,3324,3449,0,21,16041
2021-12-17,7,8177,1143,3639,3400,0,32,16391
2021-12-17,8,8177,1628,4226,3352,1,39,17423
2021-12-17,9,8176,1606,4279,3140,33,41,17275
2021-12-17,10,8186,1666,4504,2854,99,33,17342
2021-12-17,11,8187,1761,4812,2488,165,40,17453
2021-12-17,12,8195,2031,4583,2193,199,42,17243
2021-12-17,13,8213,2388,4335,1963,237,35,17171
2021-12-17,14,8250,2523,4381,1683,195,31,17063
2021-12-17,15,8341,2531,4549,1330,107,31,16889
2021-12-17,16,8528,2518,4769,979,45,30,16869
2021-12-17,17,8694,3100,5137,811,5,30,17777
2021-12-17,18,8875,3053,5601,641,0,30,18200
2021-12-17,19,8996,3161,5558,563,0,30,18308
2021-12-17,20,9081,3135,5506,586,0,30,18338
2021-12-17,21,9080,2786,5463,654,0,30,18013
2021-12-17,22,9079,2391,5394,658,0,35,17557
2021-12-17,23,9101,1725,4715,627,0,32,16200
2021-12-17,24,9136,1240,4450,531,0,13,15370
2021-12-18,1,9139,1302,3836,544,0,3,14824
2021-12-18,2,9140,1372,3715,680,0,2,14909
2021-12-18,3,9145,1400,3619,715,0,0,14879
2021-12-18,4,9439,1456,3506,880,0,0,15281
2021-12-18,5,9716,1263,3584,1014,0,0,15577
2021-12-18,6,9782,1380,3857,1089,0,0,16108
2021-12-18,7,9804,1373,4092,1036,0,0,16305
2021-12-18,8,9779,2047,4421,997,0,0,17244
2021-12-18,9,9796,1857,4515,1098,2,0,17268
2021-12-18,10,9849,2063,4730,797,4,0,17443
2021-12-18,11,9861,2373,4679,759,8,0,17680
2021-12-18,12,9863,2674,4612,703,13,2,17867
2021-12-18,13,9863,2888,4681,759,13,0,18204
2021-12-18,14,9861,3099,4511,763,9,0,18243
2021-12-18,15,9863,2980,4449,953,8,0,18253
2021-12-18,16,9863,2824,4633,938,5,0,18263
2021-12-18,17,9863,3077,5084,929,1,0,18954
2021-12-18,18,9863,3367,5396,1014,0,0,19640
2021-12-18,19,9891,3233,5221,1075,0,0,19420
2021-12-18,20,9906,1920,5261,1167,0,0,18254
2021-12-18,21,9908,2031,4893,1217,0,0,18049
2021-12-18,22,9911,2050,4684,1315,0,0,17960
2021-12-18,23,9913,1886,4323,1381,0,1,17504
2021-12-18,24,9914,1665,4106,1378,0,1,17064
2021-12-19,1,9912,1824,3669,1274,0,3,16682
2021-12-19,2,9912,1698,3617,1111,0,4,16342
2021-12-19,3,9913,1430,3608,1065,0,4,16020
2021-12-19,4,9915,1203,3648,1156,0,7,15929
2021-12-19,5,9914,1193,3639,1220,0,4,15970
2021-12-19,6,9916,1166,3718,1175,0,6,15981
2021-12-19,7,9963,1586,3878,1053,0,3,16483
2021-12-19,8,9968,1655,4515,915,1,0,17054
2021-12-19,9,9965,2257,4804,795,9,0,17830
2021-12-19,10,9964,2632,4925,640,48,0,18209
2021-12-19,11,9961,3230,4618,517,110,0,18436
2021-12-19,12,9966,3380,4537,434,163,0,18480
2021-12-19,13,9974,3334,4520,418,155,0,18401
2021-12-19,14,9986,3128,4496,399,157,0,18166
2021-12-19,15,9993,2749,4516,302,120,0,17680
2021-12-19,16,9989,2323,4828,267,59,0,17466
2021-12-19,17,9995,2370,5575,214,7,0,18161
2021-12-19,18,9991,3400,5783,277,0,0,19451
2021-12-19,19,9990,3520,5408,309,0,0,19227
2021-12-19,20,9988,3316,5234,385,0,0,18923
2021-12-19,21,9985,2756,5062,607,0,0,18410
2021-12-19,22,9987,2666,4439,785,0,0,17877
2021-12-19,23,9991,1707,4082,981,0,0,16761
2021-12-19,24,9991,1651,3507,1283,0,0,16432
2021-12-20,1,9993,1528,3209,1553,0,0,16283
2021-12-20,2,9997,1346,3196,1501,0,0,16040
2021-12-20,3,9994,1131,3213,2043,0,1,16382
2021-12-20,4,9997,943,3402,2152,0,13,16507
2021-12-20,5,9999,916,3070,2391,0,16,16392
2021-12-20,6,10004,921,3163,2283,0,20,16391
2021-12-20,7,9998,1068,3733,2745,0,26,17570
2021-12-20,8,10002,1101,4530,3520,2,34,19189
2021-12-20,9,9995,1168,4065,3520,5,34,18787
2021-12-20,10,9994,1296,4155,3930,18,31,19424
2021-12-20,11,9986,1160,4224,4033,45,32,19480
2021-12-20,12,9975,1297,4102,4129,68,32,19603
2021-12-20,13,9986,1297,3942,4276,84,32,19617
2021-12-20,14,9992,1140,3855,4268,92,31,19378
2021-12-20,15,9999,1109,3811,4206,82,30,19237
2021-12-20,16,9999,1110,3919,4170,67,32,19297
2021-12-20,17,9996,1110,4290,3529,11,31,18967
2021-12-20,18,9991,1115,4565,4160,1,26,19858
2021-12-20,19,9993,691,4356,4269,0,18,19327
2021-12-20,20,9993,541,4163,3970,0,20,18687
2021-12-20,21,9990,221,4135,3176,0,27,17549
2021-12-20,22,9987,132,3773,2433,0,31,16356
2021-12-20,23,9989,177,3338,2606,0,31,16141
2021-12-20,24,9996,196,3317,1716,0,23,15248
2021-12-21,1,9991,275,3158,1081,0,23,14528
2021-12-21,2,9994,436,3011,1207,0,18,14666
2021-12-21,3,9993,512,2990,675,0,17,14187
2021-12-21,4,9988,654,3027,869,0,17,14555
2021-12-21,5,9988,917,3110,902,0,20,14937
2021-12-21,6,9984,1309,3657,675,0,22,15647
2021-12-21,7,9988,1387,4039,379,1,34,15828
2021-12-21,8,9991,1475,4820,215,3,60,16564
2021-12-21,9,9984,1708,5076,148,33,67,17016
2021-12-21,10,9982,1647,4806,182,118,59,16794
2021-12-21,11,9982,1735,4416,270,122,69,16594
2021-12-21,12,9993,1523,4363,411,131,72,16493
2021-12-21,13,9994,1592,4205,589,115,71,16566
2021-12-21,14,9993,1768,4202,591,113,69,16736
2021-12-21,15,9995,1909,4183,658,75,68,16888
2021-12-21,16,9992,1917,4299,841,32,69,17150
2021-12-21,17,9993,1845,5235,1336,8,72,18489
2021-12-21,18,9993,1949,5564,1983,0,70,19559
2021-12-21,19,9991,1576,4818,2501,0,68,18954
2021-12-21,20,9986,1182,4706,3139,0,67,19080
2021-12-21,21,9976,1117,4480,3644,0,69,19286
2021-12-21,22,9978,946,4195,3955,0,60,19134
2021-12-21,23,9971,593,3826,4085,0,68,18543
2021-12-21,24,9986,178,3566,4241,0,60,18031
2021-12-22,1,9984,131,3182,3878,0,52,17227
2021-12-22,2,9987,155,3094,3301,0,54,16591
2021-12-22,3,9985,189,2961,3090,0,51,16276
2021-12-22,4,9986,238,2965,3293,0,53,16535
2021-12-22,5,9982,244,3067,3764,0,55,17112
2021-12-22,6,9983,275,3225,4052,0,54,17589
2021-12-22,7,9983,460,3612,4162,1,61,18279
2021-12-22,8,9975,648,4561,4211,2,65,19462
2021-12-22,9,9976,837,4543,4097,4,64,19521
2021-12-22,10,9983,1029,4896,3999,22,61,19990
2021-12-22,11,9979,1278,4341,4030,142,66,19836
2021-12-22,12,9965,1416,4221,3782,168,67,19619
2021-12-22,13,9964,1326,4251,3817,170,62,19590
2021-12-22,14,9974,1585,4297,3624,138,63,19681
2021-12-22,15,9976,1748,4440,3334,138,67,19703
2021-12-22,16,9981,1803,4579,3294,79,69,19805
2021-12-22,17,9981,1962,5343,3127,10,70,20493
2021-12-22,18,9979,2305,5755,2912,0,72,21023
2021-12-22,19,9986,2447,5600,2573,0,70,20676
2021-12-22,20,9987,1926,5547,2289,0,70,19819
2021-12-22,21,9981,1870,5370,2012,0,71,19304
2021-12-22,22,9975,1522,5341,1694,0,55,18587
2021-12-22,23,9983,1774,4952,1389,0,63,18161
2021-12-22,24,9984,1755,4429,1144,0,63,17375
2021-12-23,1,9985,1780,4275,922,0,57,17019
2021-12-23,2,9988,1467,4119,782,0,57,16413
2021-12-23,3,9990,1493,4182,788,0,56,16509
2021-12-23,4,9985,1526,4200,688,0,53,16452
2021-12-23,5,9993,1506,4402,561,0,56,16518
2021-12-23,6,9988,1547,4320,483,0,59,16397
2021-12-23,7,9988,1577,4620,407,1,67,16660
2021-12-23,8,9989,1735,5514,478,2,73,17791
2021-12-23,9,9985,2360,5237,590,17,73,18262
2021-12-23,10,9983,2233,5365,862,59,63,18565
2021-12-23,11,9987,2127,4968,1438,76,72,18668
2021-12-23,12,9995,1687,4658,2095,103,74,18612
2021-12-23,13,9997,1794,4553,2260,101,67,18772
2021-12-23,14,9996,2374,4709,2231,79,68,19457
2021-12-23,15,9995,2134,4747,2216,53,58,19203
2021-12-23,16,9999,2058,4881,2311,26,62,19337
2021-12-23,17,10000,2080,4749,2536,1,62,19428
2021-12-23,18,9996,2147,5141,2775,0,64,20123
2021-12-23,19,10000,1810,5367,2775,0,62,20014
2021-12-23,20,9998,1908,5061,2279,0,65,19311
2021-12-23,21,9995,2271,4776,2022,0,66,19130
2021-12-23,22,9996,1793,4601,1806,0,53,18249
2021-12-23,23,9986,1702,4322,1580,0,66,17656
2021-12-23,24,9988,1184,3999,1338,0,57,16566
2021-12-24,1,9986,1311,3805,961,0,56,16119
2021-12-24,2,9977,1264,3645,846,0,55,15787
2021-12-24,3,9984,1063,3579,681,0,55,15362
2021-12-24,4,9988,1353,3606,586,0,55,15588
2021-12-24,5,9989,1690,3632,425,0,55,15791
2021-12-24,6,9988,1697,3561,459,0,58,15763
2021-12-24,7,9994,1763,3787,606,0,65,16215
2021-12-24,8,9991,1931,3914,299,0,67,16202
2021-12-24,9,9988,1943,3972,935,2,67,16907
2021-12-24,10,9989,1313,4479,1454,11,64,17310
2021-12-24,11,9986,1253,4703,1546,17,60,17565
2021-12-24,12,9991,1788,4594,1820,47,35,18275
2021-12-24,13,9986,1450,4070,2316,42,59,17923
2021-12-24,14,9989,1364,3858,2479,57,67,17814
2021-12-24,15,9986,861,4245,2562,57,70,17781
2021-12-24,16,9985,738,4393,2639,21,70,17846
2021-12-24,17,9980,731,4356,2899,2,69,18037
2021-12-24,18,9998,728,4533,3014,0,70,18343
2021-12-24,19,10001,718,4473,2959,0,68,18219
2021-12-24,20,9994,249,4495,3124,0,67,17929
2021-12-24,21,9989,124,4473,3202,0,66,17854
2021-12-24,22,9992,123,3740,3221,0,64,17140
2021-12-24,23,9993,123,3687,2901,0,69,16773
2021-12-24,24,9989,123,3805,2612,0,52,16581
2021-12-25,1,9995,123,3494,2452,0,40,16104
2021-12-25,2,9998,124,3130,2401,0,38,15691
2021-12-25,3,9993,124,3173,2333,0,38,15661
2021-12-25,4,9999,244,3286,2140,0,36,15705
2021-12-25,5,10006,223,3222,1846,0,35,15332
2021-12-25,6,10009,195,3242,1608,0,37,15091
2021-12-25,7,10007,129,3557,1396,0,37,15126
2021-12-25,8,10004,240,3787,1213,1,35,15280
2021-12-25,9,10000,442,4279,1132,2,30,15885
2021-12-25,10,10006,804,4328,1375,15,25,16553
2021-12-25,11,10001,915,4369,1647,21,39,16992
2021-12-25,12,9993,833,4288,1981,20,43,17158
2021-12-25,13,10004,911,4021,2659,18,43,17656
2021-12-25,14,10002,782,3714,2824,18,38,17378
2021-12-25,15,10002,847,4117,2624,14,32,17636
2021-12-25,16,10004,815,4175,2596,6,30,17626
2021-12-25,17,10002,812,4685,2377,1,27,17904
2021-12-25,18,10008,1042,4533,2540,0,28,18151
2021-12-25,19,10006,925,4316,2397,0,28,17672
2021-12-25,20,10006,919,4432,2205,0,34,17596
2021-12-25,21,10002,700,4439,1626,0,21,16788
2021-12-25,22,10004,790,4340,1222,0,11,16367
2021-12-25,23,10003,777,3818,912,0,11,15521
2021-12-25,24,10003,588,3286,1017,0,14,14908
2021-12-26,1,10002,162,3786,928,0,12,14890
2021-12-26,2,10003,146,3638,787,0,16,14590
2021-12-26,3,10007,124,3872,523,0,17,14543
2021-12-26,4,10013,234,3847,493,0,10,14597
2021-12-26,5,10013,339,3583,517,0,5,14457
2021-12-26,6,10007,440,3229,683,0,18,14377
2021-12-26,7,10014,874,3412,817,0,28,15145
2021-12-26,8,10012,1113,3723,785,1,31,15665
2021-12-26,9,10008,1264,4132,807,9,30,16250
2021-12-26,10,10010,1331,4250,804,32,24,16451
2021-12-26,11,10015,1556,4396,629,61,15,16672
2021-12-26,12,10016,2075,4206,669,93,17,17076
2021-12-26,13,10013,1977,4118,656,100,24,16888
2021-12-26,14,10015,1966,3784,639,84,26,16514
2021-12-26,15,10013,1944,4084,660,51,24,16776
2021-12-26,16,10010,1643,4404,660,25,24,16766
2021-12-26,17,10008,1716,4507,691,4,25,16951
2021-12-26,18,10005,1829,5254,678,0,25,17791
2021-12-26,19,10011,1674,5227,751,0,25,17688
2021-12-26,20,10011,1628,4927,736,0,29,17331
2021-12-26,21,10010,1770,4773,784,0,25,17362
2021-12-26,22,10010,1647,4378,947,0,24,17006
2021-12-26,23,10009,1677,3773,1041,0,29,16529
2021-12-26,24,10008,954,3703,1307,0,28,16000
2021-12-27,1,10004,863,3838,1474,0,32,16211
2021-12-27,2,10005,302,3466,1765,0,32,15570
2021-12-27,3,10010,185,3817,1867,0,28,15907
2021-12-27,4,10009,135,3073,2564,0,28,15809
2021-12-27,5,10008,130,3618,2227,0,26,16009
2021-12-27,6,10009,248,3708,2635,0,25,16625
2021-12-27,7,10010,242,3383,2593,0,25,16253
2021-12-27,8,10005,323,3557,2661,1,27,16574
2021-12-27,9,10004,653,3661,3087,3,29,17437
2021-12-27,10,10003,1101,3975,3166,8,19,18272
2021-12-27,11,10006,1397,4003,3340,15,22,18783
2021-12-27,12,10008,1775,3708,3412,25,24,18952
2021-12-27,13,10008,1765,4106,3245,25,21,19170
2021-12-27,14,10008,1778,4360,2619,28,25,18818
2021-12-27,15,10006,2088,4404,2227,20,27,18772
2021-12-27,16,10009,1727,4652,1803,7,28,18226
2021-12-27,17,9997,1891,5187,1658,1,27,18761
2021-12-27,18,9981,2409,5284,1589,0,30,19293
2021-12-27,19,9970,2489,5047,1289,0,28,18823
2021-12-27,20,9976,2803,4969,1031,0,27,18806
2021-12-27,21,9967,2702,4553,1314,0,31,18567
2021-12-27,22,9967,2552,4363,1554,0,24,18460
2021-12-27,23,9954,1719,3916,1924,0,32,17545
2021-12-27,24,9975,927,3398,2218,0,36,16554
2021-12-28,1,9987,256,3379,2480,0,36,16138
2021-12-28,2,9991,124,3414,2663,0,34,16226
2021-12-28,3,10003,128,3298,2962,0,32,16423
2021-12-28,4,10050,124,3074,3072,0,32,16352
2021-12-28,5,10082,221,2943,2790,0,33,16069
2021-12-28,6,10084,391,3158,2247,0,36,15916
2021-12-28,7,10082,672,3287,2315,0,37,16393
2021-12-28,8,10078,983,3663,2288,1,36,17049
2021-12-28,9,10083,1142,4032,1974,10,36,17277
2021-12-28,10,10074,1628,4339,1508,47,27,17623
2021-12-28,11,10073,2137,4433,1015,109,29,17796
2021-12-28,12,10069,2374,4443,678,75,34,17673
2021-12-28,13,10133,2608,4398,291,100,35,17565
2021-12-28,14,10222,2544,4453,134,55,33,17441
2021-12-28,15,10236,2722,4438,76,23,33,17528
2021-12-28,16,10247,2694,4854,65,10,35,17905
2021-12-28,17,10254,2848,5183,220,0,35,18540
2021-12-28,18,10261,3540,5303,524,0,38,19666
2021-12-28,19,10282,2883,5128,845,0,41,19179
2021-12-28,20,10277,2391,4968,829,0,42,18507
2021-12-28,21,10273,2525,5066,545,0,42,18451
2021-12-28,22,10275,2620,4442,623,0,30,17990
2021-12-28,23,10275,1671,3843,996,0,40,16825
2021-12-28,24,10274,959,3648,1188,0,42,16111
2021-12-29,1,10276,299,3530,1078,0,43,15226
2021-12-29,2,10282,251,3482,1008,0,43,15066
2021-12-29,3,10282,485,3423,923,0,46,15159
2021-12-29,4,10286,643,3496,757,0,54,15236
2021-12-29,5,10288,1156,3541,668,0,54,15707
2021-12-29,6,10284,1365,3250,713,0,61,15673
2021-12-29,7,10290,1833,3479,778,0,64,16444
2021-12-29,8,10287,2241,3433,859,1,67,16888
2021-12-29,9,10289,2347,3554,889,6,68,17153
2021-12-29,10,10284,2361,4091,870,14,61,17681
2021-12-29,11,10289,2585,4435,695,33,61,18098
2021-12-29,12,10285,2568,4391,658,52,60,18014
2021-12-29,13,10280,2467,4339,844,52,58,18040
2021-12-29,14,10280,2232,4317,959,47,46,17881
2021-12-29,15,10278,2166,4457,1098,36,33,18068
2021-12-29,16,10276,2467,4818,1126,11,32,18730
2021-12-29,17,10270,2363,5087,914,3,33,18670
2021-12-29,18,10299,3084,5219,927,1,32,19562
2021-12-29,19,10391,2288,5003,974,0,32,18688
2021-12-29,20,10397,2187,4873,920,0,33,18410
2021-12-29,21,10395,1941,4838,999,0,34,18207
2021-12-29,22,10397,1650,4387,946,0,44,17424
2021-12-29,23,10433,1315,3568,844,0,55,16215
2021-12-29,24,10440,753,3874,777,0,42,15886
2021-12-30,1,10439,336,3687,598,0,34,15094
2021-12-30,2,10440,212,3692,582,0,31,14957
2021-12-30,3,10446,249,3765,570,0,31,15061
2021-12-30,4,10463,461,3579,534,0,31,15068
2021-12-30,5,10459,869,3542,377,0,22,15269
2021-12-30,6,10458,1246,3525,284,0,18,15531
2021-12-30,7,10464,1607,3811,280,0,29,16191
2021-12-30,8,10459,2072,3714,145,2,31,16423
2021-12-30,9,10455,2212,4056,131,7,31,16892
2021-12-30,10,10454,2435,4068,135,27,31,17150
2021-12-30,11,10453,2447,4131,56,46,31,17164
2021-12-30,12,10458,2524,4026,21,81,27,17137
2021-12-30,13,10455,2676,4060,6,61,21,17279
2021-12-30,14,10459,2706,4209,24,46,32,17476
2021-12-30,15,10451,2664,4075,13,23,36,17262
2021-12-30,16,10456,2451,4225,48,7,50,17237
2021-12-30,17,10456,2233,4657,80,3,45,17474
2021-12-30,18,10452,2506,4998,110,0,50,18116
2021-12-30,19,10452,2118,4784,162,0,45,17561
2021-12-30,20,10457,2101,4696,246,0,34,17534
2021-12-30,21,10454,1688,4477,343,0,32,16994
2021-12-30,22,10457,1756,4122,450,0,37,16822
2021-12-30,23,10456,1390,3698,478,0,45,16067
2021-12-30,24,10465,913,3651,512,0,45,15586
2021-12-31,1,10466,371,3721,450,0,36,15044
2021-12-31,2,10466,219,3635,502,0,34,14856
2021-12-31,3,10468,138,3603,549,0,24,14782
2021-12-31,4,10463,125,3526,614,0,15,14743
2021-12-31,5,10466,130,3602,666,0,15,14879
2021-12-31,6,10468,246,3373,836,0,17,14940
2021-12-31,7,10469,485,3307,960,0,27,15248
2021-12-31,8,10467,891,3562,945,2,32,15899
2021-12-31,9,10464,1390,4145,789,3,33,16824
2021-12-31,10,10461,1793,4233,703,15,32,17237
2021-12-31,11,10461,1780,4437,638,28,32,17376
2021-12-31,12,10465,1704,4323,704,35,32,17263
2021-12-31,13,10467,1586,4089,810,77,31,17060
2021-12-31,14,10467,1625,4116,707,108,32,17055
2021-12-31,15,10468,1838,4162,550,94,32,17144
2021-12-31,16,10467,1902,4321,367,32,32,17121
2021-12-31,17,10470,1970,4357,129,0,32,16958
2021-12-31,18,10472,2200,4891,94,0,32,17689
2021-12-31,19,10476,1765,4654,252,0,32,17179
2021-12-31,20,10471,1384,4330,635,0,32,16852
2021-12-31,21,10470,1216,4112,820,0,31,16649
2021-12-31,22,10473,973,3585,991,0,32,16054
2021-12-31,23,10472,323,3643,797,0,32,15267
2021-12-31,24,10470,175,3682,716,0,21,15064
