Date,Hour,Nuclear,Gas,Hydro,Wind,Solar,Biofuel,Total
2022-01-01,1,10474,163,3872,458,0,5,14972
2022-01-01,2,10480,202,4076,300,0,0,15058
2022-01-01,3,10481,183,3570,320,0,0,14554
2022-01-01,4,10483,123,3332,348,0,1,14287
2022-01-01,5,10485,123,3067,267,0,1,13943
2022-01-01,6,10484,126,3158,687,0,4,14459
2022-01-01,7,10482,127,3124,965,0,8,14706
2022-01-01,8,10478,124,3234,1412,0,10,15258
2022-01-01,9,10479,123,3427,1073,4,9,15115
2022-01-01,10,10477,123,3593,1506,12,2,15713
2022-01-01,11,10475,134,4119,1822,14,5,16569
2022-01-01,12,10479,186,4261,2165,18,6,17115
2022-01-01,13,10478,246,4363,2344,17,4,17452
2022-01-01,14,10476,347,4183,2510,15,0,17531
2022-01-01,15,10473,420,4033,2797,11,0,17734
2022-01-01,16,10470,532,4114,2570,5,0,17691
2022-01-01,17,10478,540,4487,2599,0,0,18104
2022-01-01,18,10477,589,4721,2585,0,0,18372
2022-01-01,19,10473,574,4667,2653,0,0,18367
2022-01-01,20,10477,584,4650,2738,0,0,18449
2022-01-01,21,10467,568,4318,2817,0,0,18170
2022-01-01,22,10469,216,4124,2956,0,0,17765
2022-01-01,23,10472,125,3548,2953,0,0,17098
2022-01-01,24,10470,123,3481,2809,0,0,16883
2022-01-02,1,10474,123,3066,2889,0,0,16552
2022-01-02,2,10474,123,3078,2821,0,0,16496
2022-01-02,3,10475,124,2904,2746,0,0,16249
2022-01-02,4,10473,129,3031,2702,0,0,16335
2022-01-02,5,10476,182,2939,2690,0,0,16287
2022-01-02,6,10478,328,2986,2764,0,0,16556
2022-01-02,7,10475,591,2982,2532,0,0,16580
2022-01-02,8,10473,1025,3038,2348,0,0,16884
2022-01-02,9,10468,1186,3208,2199,2,0,17063
2022-01-02,10,10462,1227,3592,2238,4,0,17523
2022-01-02,11,10465,1286,3815,2193,10,2,17771
2022-01-02,12,10461,1405,3720,2274,19,3,17882
2022-01-02,13,10460,1689,3849,2226,22,0,18246
2022-01-02,14,10428,1614,3781,2137,25,0,17985
2022-01-02,15,10420,1623,4048,1922,21,0,18034
2022-01-02,16,10423,1837,4050,1706,10,0,18026
2022-01-02,17,10428,2009,4788,1397,1,0,18623
2022-01-02,18,10435,2875,5256,1252,0,0,19818
2022-01-02,19,10445,2825,5094,1349,0,0,19713
2022-01-02,20,10445,2663,4708,1296,0,0,19112
2022-01-02,21,10442,2498,4708,1097,0,0,18745
2022-01-02,22,10445,2398,4519,987,0,1,18350
2022-01-02,23,10441,2170,3932,898,0,11,17452
2022-01-02,24,10444,1931,3769,796,0,39,16979
2022-01-03,1,10442,1730,3403,664,0,53,16292
2022-01-03,2,10447,1682,3182,567,0,51,15929
2022-01-03,3,10447,1955,3215,383,0,51,16051
2022-01-03,4,10449,2394,3178,373,0,51,16445
2022-01-03,5,10444,2396,3226,526,0,51,16643
2022-01-03,6,10444,2297,3152,757,0,51,16701
2022-01-03,7,10441,2583,3901,814,0,53,17792
2022-01-03,8,10442,3575,4458,624,0,53,19152
2022-01-03,9,10441,3552,4626,595,3,53,19270
2022-01-03,10,10444,3815,4735,426,13,53,19486
2022-01-03,11,10444,4438,4472,425,27,53,19859
2022-01-03,12,10443,4529,4190,408,41,54,19665
2022-01-03,13,10382,4105,4112,507,54,53,19213
2022-01-03,14,10319,3862,4103,596,60,53,18993
2022-01-03,15,10338,3524,4123,732,54,53,18824
2022-01-03,16,10337,3721,4624,832,28,53,19595
2022-01-03,17,10326,4260,5154,1026,9,54,20829
2022-01-03,18,10322,5197,5289,1288,0,54,22150
2022-01-03,19,10332,4640,5247,1517,0,54,21790
2022-01-03,20,10334,3498,4911,2039,0,54,20836
2022-01-03,21,10337,3102,4574,2390,0,54,20457
2022-01-03,22,10338,2158,3817,2733,0,54,19100
2022-01-03,23,10336,1227,3086,3096,0,54,17799
2022-01-03,24,10333,598,2979,3135,0,53,17098
2022-01-04,1,10332,508,3036,3264,0,54,17194
2022-01-04,2,10326,517,2866,3267,0,66,17042
2022-01-04,3,10154,703,2840,3155,0,69,16921
2022-01-04,4,9998,1067,3138,3060,0,70,17333
2022-01-04,5,10000,1711,3136,2861,0,70,17778
2022-01-04,6,9997,2601,3430,2369,0,73,18470
2022-01-04,7,9998,3715,3589,1875,0,80,19257
2022-01-04,8,9999,3976,4298,2042,1,85,20401
2022-01-04,9,10005,4089,4332,2268,4,85,20783
2022-01-04,10,10002,3681,4444,2471,20,85,20703
2022-01-04,11,10003,2739,4287,2714,44,84,19871
2022-01-04,12,10018,2502,4013,2592,67,85,19277
2022-01-04,13,9999,2705,3897,2448,84,88,19221
2022-01-04,14,9998,2165,3827,2753,128,84,18955
2022-01-04,15,9994,1957,4141,2837,108,55,19092
2022-01-04,16,9992,1991,4674,2764,47,32,19500
2022-01-04,17,9994,2154,5226,2910,8,32,20324
2022-01-04,18,9995,2808,5371,3071,0,35,21280
2022-01-04,19,9998,2356,5201,3153,0,36,20744
2022-01-04,20,9995,2342,4984,3357,0,40,20718
2022-01-04,21,9999,2116,4514,3559,0,42,20230
2022-01-04,22,10012,1151,3783,3706,0,34,18686
2022-01-04,23,10022,942,3289,3793,0,25,18071
2022-01-04,24,10020,602,3043,3819,0,28,17512
2022-01-05,1,10023,213,2694,3615,0,21,16566
2022-01-05,2,10020,128,2658,3474,0,17,16297
2022-01-05,3,10020,126,2643,2922,0,17,15728
2022-01-05,4,10023,126,2755,2329,0,18,15251
2022-01-05,5,10020,126,2839,2476,0,18,15479
2022-01-05,6,10016,137,2912,2834,0,20,15919
2022-01-05,7,10020,240,2993,3061,0,26,16340
2022-01-05,8,10022,468,3448,3578,0,33,17549
2022-01-05,9,10023,642,3639,3350,4,33,17691
2022-01-05,10,10021,727,3704,3937,15,32,18436
2022-01-05,11,10017,821,4308,4014,18,31,19209
2022-01-05,12,10019,1475,4266,4061,29,31,19881
2022-01-05,13,10018,1731,4205,4041,28,31,20054
2022-01-05,14,10016,1654,3664,3938,20,31,19323
2022-01-05,15,10013,1375,4151,4119,12,32,19702
2022-01-05,16,10018,1244,3911,4212,7,31,19423
2022-01-05,17,10012,1375,4205,4264,3,32,19891
2022-01-05,18,10010,1578,4569,4235,0,33,20425
2022-01-05,19,10019,1555,4177,4338,0,33,20122
2022-01-05,20,10010,1086,3776,4372,0,32,19276
2022-01-05,21,10013,797,4106,4384,0,27,19327
2022-01-05,22,10012,614,3523,4357,0,22,18528
2022-01-05,23,10010,542,3372,4142,0,46,18112
2022-01-05,24,10009,245,3238,4093,0,65,17650
2022-01-06,1,10006,129,3389,3804,0,65,17393
2022-01-06,2,10000,131,3401,3880,0,64,17476
2022-01-06,3,10005,138,3396,3974,0,64,17577
2022-01-06,4,10013,282,3415,3807,0,65,17582
2022-01-06,5,10020,646,3326,3676,0,65,17733
2022-01-06,6,10021,1246,3302,3383,0,67,18019
2022-01-06,7,10018,1547,3573,3095,1,72,18306
2022-01-06,8,10006,1977,4072,2976,2,79,19112
2022-01-06,9,9995,1995,4796,2806,9,79,19680
2022-01-06,10,9986,2179,4829,2595,58,80,19727
2022-01-06,11,9978,2318,4578,2515,91,81,19561
2022-01-06,12,9972,2419,4875,2313,109,82,19770
2022-01-06,13,9969,2563,5013,1991,139,84,19759
2022-01-06,14,9971,2736,5022,1611,132,84,19556
2022-01-06,15,9956,2889,4948,1411,65,82,19351
2022-01-06,16,9956,3093,5337,1315,28,82,19811
2022-01-06,17,9968,3687,5962,1141,5,80,20843
2022-01-06,18,9965,4565,5961,987,1,81,21560
2022-01-06,19,9979,4115,5916,1003,0,82,21095
2022-01-06,20,9978,4133,5467,1018,0,83,20679
2022-01-06,21,9978,4357,5263,1052,0,83,20733
2022-01-06,22,9971,3868,4772,1054,0,81,19746
2022-01-06,23,9982,2830,4367,1151,0,83,18413
2022-01-06,24,9988,2337,3998,1222,0,75,17620
2022-01-07,1,9981,2068,3614,1162,0,67,16892
2022-01-07,2,9992,1850,3454,1280,0,66,16642
2022-01-07,3,9990,1779,3469,1446,0,66,16750
2022-01-07,4,9991,1668,3310,1636,0,66,16671
2022-01-07,5,9995,1606,3178,1708,0,66,16553
2022-01-07,6,9992,1899,3535,1879,0,28,17333
2022-01-07,7,9992,2694,3985,1902,0,25,18598
2022-01-07,8,9990,3514,4420,1988,1,31,19944
2022-01-07,9,9986,3622,4901,1894,11,31,20445
2022-01-07,10,9990,3920,4688,1823,64,32,20517
2022-01-07,11,9996,3118,4642,1980,171,32,19939
2022-01-07,12,10000,2761,4626,1996,229,32,19644
2022-01-07,13,9996,2575,4676,2018,228,32,19525
2022-01-07,14,9995,2386,4709,2139,157,31,19417
2022-01-07,15,10008,2489,4373,2301,132,31,19334
2022-01-07,16,10023,2706,4339,2417,102,31,19618
2022-01-07,17,10022,3002,5225,2328,20,31,20628
2022-01-07,18,10026,4335,5775,1763,1,32,21932
2022-01-07,19,10028,4414,5692,1457,0,32,21623
2022-01-07,20,10029,4400,5378,1303,0,32,21142
2022-01-07,21,10030,4639,4977,1108,0,32,20786
2022-01-07,22,10030,4441,4511,949,0,32,19963
2022-01-07,23,10035,4423,4138,750,0,32,19378
2022-01-07,24,10034,3915,3998,706,0,21,18674
2022-01-08,1,10032,3425,3795,683,0,0,17935
2022-01-08,2,10034,3362,3598,623,0,0,17617
2022-01-08,3,10033,3088,3568,701,0,0,17390
2022-01-08,4,10033,3017,3580,741,0,0,17371
2022-01-08,5,10030,3205,3469,842,0,0,17546
2022-01-08,6,10028,3320,3591,974,0,0,17913
2022-01-08,7,10026,2421,3613,1411,0,0,17471
2022-01-08,8,10021,2475,3851,2169,3,0,18519
2022-01-08,9,10024,2481,3714,1805,23,0,18047
2022-01-08,10,10025,2562,3605,1955,58,0,18205
2022-01-08,11,10025,2271,3480,2152,125,0,18053
2022-01-08,12,10029,2150,3210,2584,164,0,18137
2022-01-08,13,10026,2139,3180,2825,199,0,18369
2022-01-08,14,10033,2120,3077,3128,228,0,18586
2022-01-08,15,10032,1904,3441,3331,193,0,18901
2022-01-08,16,10032,1916,3995,3313,82,0,19338
2022-01-08,17,10029,2078,4656,3235,18,0,20016
2022-01-08,18,10029,2982,5067,3325,1,0,21404
2022-01-08,19,10033,2810,4568,3659,0,0,21070
2022-01-08,20,10034,2112,4062,4017,0,0,20225
2022-01-08,21,10033,1714,3601,4099,0,0,19447
2022-01-08,22,10028,974,3317,4135,0,0,18454
2022-01-08,23,10031,410,3400,4031,0,17,17889
2022-01-08,24,10032,151,3339,3919,0,50,17491
2022-01-09,1,10039,126,2936,3621,0,53,16775
2022-01-09,2,10038,126,3200,3487,0,52,16903
2022-01-09,3,10032,125,2794,3267,0,52,16270
2022-01-09,4,10031,126,2791,3037,0,52,16037
2022-01-09,5,10036,125,2784,3384,0,53,16382
2022-01-09,6,10032,125,2803,3243,0,53,16256
2022-01-09,7,10038,125,2920,3351,0,52,16486
2022-01-09,8,10038,129,3247,3680,0,52,17146
2022-01-09,9,10033,131,3582,3677,0,52,17475
2022-01-09,10,10031,210,3602,3823,4,52,17722
2022-01-09,11,10036,227,3687,3822,18,52,17842
2022-01-09,12,10032,507,3527,3909,27,54,18056
2022-01-09,13,10037,879,3514,3703,51,54,18238
2022-01-09,14,10032,1100,3482,3339,56,54,18063
2022-01-09,15,10034,1196,3516,2984,51,54,17835
2022-01-09,16,9992,1356,3614,2633,30,54,17679
2022-01-09,17,10032,1502,3756,2642,13,54,17999
2022-01-09,18,10035,1507,3747,3438,0,54,18781
2022-01-09,19,10032,1492,3855,3253,0,54,18686
2022-01-09,20,10034,1258,3658,3366,0,55,18371
2022-01-09,21,10029,1164,3649,3641,0,54,18537
2022-01-09,22,10026,697,3858,3868,0,53,18502
2022-01-09,23,10022,216,3796,3997,0,11,18042
2022-01-09,24,10017,141,3257,3921,0,0,17336
2022-01-10,1,10035,148,3457,3722,0,0,17362
2022-01-10,2,10039,190,3692,3581,0,7,17509
2022-01-10,3,10038,205,3492,3702,0,15,17452
2022-01-10,4,10040,265,3560,3551,0,14,17430
2022-01-10,5,10035,653,3682,3285,0,15,17670
2022-01-10,6,10035,896,3664,3096,0,18,17709
2022-01-10,7,10036,1578,3501,2984,0,27,18126
2022-01-10,8,10028,1932,4453,2914,2,32,19361
2022-01-10,9,10031,2086,4741,2960,12,32,19862
2022-01-10,10,10033,2097,4369,3265,44,33,19841
2022-01-10,11,10035,2082,3995,3224,103,32,19471
2022-01-10,12,10020,2098,4181,3552,134,31,20016
2022-01-10,13,10035,2184,4215,3542,162,31,20169
2022-01-10,14,10036,2329,4320,3596,132,31,20444
2022-01-10,15,10030,2504,4250,3819,98,32,20733
2022-01-10,16,10022,2670,4406,3805,50,33,20986
2022-01-10,17,10016,2748,4537,3872,18,31,21222
2022-01-10,18,10019,2850,5361,3983,1,31,22245
2022-01-10,19,10020,2923,5089,4024,0,32,22088
2022-01-10,20,10026,2855,4769,4002,0,31,21683
2022-01-10,21,10017,2609,4951,3913,0,36,21526
2022-01-10,22,10021,2432,4260,3045,0,31,19789
2022-01-10,23,10021,2284,3839,2615,0,31,18790
2022-01-10,24,10023,2261,3664,2458,0,22,18428
2022-01-11,1,10029,2240,3549,2349,0,17,18184
2022-01-11,2,10035,2126,3201,1504,0,17,16883
2022-01-11,3,10033,2167,3188,1081,0,17,16486
2022-01-11,4,10037,2256,3693,1055,0,17,17058
2022-01-11,5,10029,3016,3974,859,0,16,17894
2022-01-11,6,10030,3261,4646,704,0,18,18659
2022-01-11,7,10028,4452,5211,655,0,24,20370
2022-01-11,8,10028,4903,5420,830,1,27,21209
2022-01-11,9,10024,5297,5665,831,9,27,21853
2022-01-11,10,10022,5976,5641,861,32,28,22560
2022-01-11,11,10023,5883,5435,983,61,29,22414
2022-01-11,12,10024,5278,4914,1366,60,30,21672
2022-01-11,13,10014,5002,4509,1788,73,29,21415
2022-01-11,14,9651,4511,4502,2128,101,30,20923
2022-01-11,15,10033,4348,4537,2600,71,32,21621
2022-01-11,16,10034,4273,4761,3127,33,30,22258
2022-01-11,17,10027,4354,4969,3539,10,31,22930
2022-01-11,18,10026,4687,4899,4024,1,34,23671
2022-01-11,19,10033,4383,4787,4208,0,30,23441
2022-01-11,20,10033,4594,4472,4346,0,31,23476
2022-01-11,21,10028,4669,3987,4387,0,32,23103
2022-01-11,22,10032,3380,3639,4336,0,32,21419
2022-01-11,23,10027,2768,3062,3939,0,33,19829
2022-01-11,24,10026,1390,3467,4208,0,22,19113
2022-01-12,1,10030,1337,3177,4149,0,19,18712
2022-01-12,2,10022,1012,2929,3772,0,18,17753
2022-01-12,3,10035,954,2925,3061,0,18,16993
2022-01-12,4,10036,638,2890,2862,0,19,16445
2022-01-12,5,10036,570,2881,3364,0,18,16869
2022-01-12,6,10036,758,2980,3047,0,19,16840
2022-01-12,7,10039,1188,3060,3479,0,24,17790
2022-01-12,8,10036,1791,3423,3791,1,32,19074
2022-01-12,9,10031,2502,3457,3435,4,32,19461
2022-01-12,10,10036,2811,3805,3265,20,34,19971
2022-01-12,11,9875,3627,4118,2742,39,35,20436
2022-01-12,12,9852,4395,4233,2325,32,38,20875
2022-01-12,13,9924,4711,4188,1924,31,39,20817
2022-01-12,14,10038,4321,4243,1416,31,33,20082
2022-01-12,15,10037,4812,4470,1043,24,34,20420
2022-01-12,16,10040,5047,4706,848,14,46,20701
2022-01-12,17,10034,4568,5322,686,3,49,20662
2022-01-12,18,10033,4967,5533,575,1,33,21142
2022-01-12,19,10037,5164,5492,407,0,33,21133
2022-01-12,20,10032,5293,5398,305,0,31,21059
2022-01-12,21,10028,5619,5099,175,0,31,20952
2022-01-12,22,10029,5628,4636,175,0,31,20499
2022-01-12,23,10028,4589,4133,219,0,31,19000
2022-01-12,24,10030,3741,4040,219,0,21,18051
2022-01-13,1,10029,2931,3918,204,0,16,17098
2022-01-13,2,10025,2583,3819,175,0,15,16617
2022-01-13,3,10032,2291,3787,145,0,16,16271
2022-01-13,4,10026,2377,3876,74,0,15,16368
2022-01-13,5,10022,2758,3971,41,0,17,16809
2022-01-13,6,10030,3296,4087,68,0,20,17501
2022-01-13,7,10033,3587,4414,76,0,28,18138
2022-01-13,8,10028,3823,4757,93,1,31,18733
2022-01-13,9,10027,4075,4820,142,3,32,19099
2022-01-13,10,10012,4686,4566,184,14,32,19494
2022-01-13,11,10026,5026,4636,197,24,32,19941
2022-01-13,12,10022,5408,4647,219,39,33,20368
2022-01-13,13,10028,5428,4518,244,45,33,20296
2022-01-13,14,10038,4714,4305,201,41,32,19331
2022-01-13,15,10032,4637,4456,506,34,32,19697
2022-01-13,16,10033,4268,4798,524,12,32,19667
2022-01-13,17,10032,4151,5366,477,5,32,20063
2022-01-13,18,10028,4565,5408,596,0,19,20616
2022-01-13,19,10027,4538,5452,490,0,29,20536
2022-01-13,20,10027,4647,5096,430,0,30,20230
2022-01-13,21,10029,4549,4621,628,0,30,19857
2022-01-13,22,10031,3814,4404,645,0,30,18924
2022-01-13,23,10015,2808,4220,827,0,31,17901
2022-01-13,24,10031,2200,4208,918,0,21,17378
2022-01-14,1,10033,2292,4056,793,0,15,17189
2022-01-14,2,10028,2279,3902,734,0,15,16958
2022-01-14,3,10027,2002,3852,732,0,15,16628
2022-01-14,4,10029,2380,3772,911,0,15,17107
2022-01-14,5,10023,2379,3773,1256,0,17,17448
2022-01-14,6,10021,2249,3954,1506,0,21,17751
2022-01-14,7,10021,2386,4357,1669,1,26,18460
2022-01-14,8,10021,2823,4704,1976,1,31,19556
2022-01-14,9,10008,2872,4923,2423,14,32,20272
2022-01-14,10,9991,2566,4649,2754,50,32,20042
2022-01-14,11,10019,2746,4279,2780,98,33,19955
2022-01-14,12,10024,2930,4025,2686,149,32,19846
2022-01-14,13,10021,2942,4189,2604,178,31,19965
2022-01-14,14,10028,2967,4048,2582,185,32,19842
2022-01-14,15,10029,3058,3874,2677,204,30,19872
2022-01-14,16,10031,3069,3993,2649,150,32,19924
2022-01-14,17,10026,3247,4647,2755,34,32,20741
2022-01-14,18,10022,4288,5074,2864,1,32,22281
2022-01-14,19,10025,4298,4982,3023,0,32,22360
2022-01-14,20,10024,3920,4820,3069,0,31,21864
2022-01-14,21,10025,3938,4668,2902,0,31,21564
2022-01-14,22,10023,4253,4291,2802,0,31,21400
2022-01-14,23,10018,3167,3860,2621,0,31,19697
2022-01-14,24,10024,3014,3740,2346,0,17,19141
2022-01-15,1,10020,2559,3988,2274,0,9,18850
2022-01-15,2,10024,2941,3860,2222,0,0,19047
2022-01-15,3,10025,3190,3903,2204,0,0,19322
2022-01-15,4,10024,3546,3845,2098,0,0,19513
2022-01-15,5,10028,3780,3838,1918,0,0,19564
2022-01-15,6,10032,4141,4103,1945,0,0,20221
2022-01-15,7,10032,4415,4240,1800,1,0,20488
2022-01-15,8,10033,4587,4669,1581,2,0,20872
2022-01-15,9,10028,4986,4985,1397,19,0,21415
2022-01-15,10,10030,4776,4964,1113,77,1,20961
2022-01-15,11,10028,5014,4635,858,162,0,20697
2022-01-15,12,10033,5046,4552,608,209,0,20448
2022-01-15,13,10027,4895,4418,475,218,0,20033
2022-01-15,14,10028,4551,4267,398,213,0,19457
2022-01-15,15,10029,4236,4282,451,173,0,19171
2022-01-15,16,10029,4541,4653,475,111,0,19809
2022-01-15,17,10021,5732,5252,398,31,0,21434
2022-01-15,18,10022,6350,5556,361,1,0,22290
2022-01-15,19,10026,6065,5564,516,0,0,22171
2022-01-15,20,10027,5982,5419,585,0,1,22014
2022-01-15,21,10029,5790,5027,755,0,0,21601
2022-01-15,22,10027,5654,4437,1088,0,0,21206
2022-01-15,23,10026,5563,4096,1300,0,0,20985
2022-01-15,24,10027,5267,4028,1338,0,0,20660
2022-01-16,1,10030,4863,3941,1427,0,0,20261
2022-01-16,2,10037,4674,3726,1566,0,0,20003
2022-01-16,3,10037,4614,3825,1605,0,0,20081
2022-01-16,4,10038,4890,3743,1349,0,0,20020
2022-01-16,5,10042,5094,3686,1362,0,0,20184
2022-01-16,6,10039,4966,3807,1378,0,0,20190
2022-01-16,7,10041,4714,4033,1365,1,0,20154
2022-01-16,8,10043,4945,4214,1397,1,0,20600
2022-01-16,9,10043,4734,4502,1480,28,0,20787
2022-01-16,10,10036,4520,4554,1175,109,0,20394
2022-01-16,11,10033,4700,4450,920,198,0,20301
2022-01-16,12,10034,4985,4238,815,271,0,20343
2022-01-16,13,10040,4891,4217,571,283,0,20002
2022-01-16,14,10036,4899,4144,405,235,0,19719
2022-01-16,15,10041,3842,4148,488,185,0,18704
2022-01-16,16,10042,4070,4218,766,119,0,19215
2022-01-16,17,10039,4385,4660,881,25,0,19990
2022-01-16,18,10039,5756,5038,724,1,0,21558
2022-01-16,19,10046,5814,5070,898,0,0,21828
2022-01-16,20,10048,5133,4732,1526,0,0,21439
2022-01-16,21,10052,4864,4619,1516,0,0,21051
2022-01-16,22,10048,5078,4191,1196,0,0,20513
2022-01-16,23,10047,5094,3882,846,0,0,19869
2022-01-16,24,10052,5063,3784,830,0,0,19729
2022-01-17,1,10053,3915,3660,1219,0,0,18847
2022-01-17,2,10050,3138,3640,1799,0,4,18631
2022-01-17,3,10054,2612,3114,2200,0,13,17993
2022-01-17,4,10061,2433,3143,1942,0,15,17594
2022-01-17,5,10062,2517,3035,1699,0,15,17328
2022-01-17,6,10065,2571,3198,1572,0,16,17422
2022-01-17,7,10054,2592,3272,2586,0,28,18532
2022-01-17,8,10057,2612,3666,3108,0,32,19475
2022-01-17,9,10042,2638,3684,3735,2,33,20134
2022-01-17,10,10042,2637,3742,3784,10,32,20247
2022-01-17,11,10049,2510,4008,3757,22,32,20378
2022-01-17,12,10048,2836,3859,3774,21,32,20570
2022-01-17,13,10050,2809,3414,3704,12,33,20022
2022-01-17,14,10053,2548,3392,3646,17,33,19689
2022-01-17,15,10054,2453,3384,3419,12,33,19355
2022-01-17,16,10051,2470,3647,3414,6,33,19621
2022-01-17,17,10053,2472,3917,3731,1,33,20207
2022-01-17,18,10052,2546,4734,3790,0,31,21153
2022-01-17,19,10050,2454,4350,3783,0,31,20668
2022-01-17,20,10052,2159,4206,3508,0,31,19956
2022-01-17,21,10055,1787,4390,3272,0,31,19535
2022-01-17,22,10059,1714,3588,3224,0,31,18616
2022-01-17,23,10050,1389,3475,2974,0,31,17919
2022-01-17,24,10055,1100,3332,2783,0,24,17294
2022-01-18,1,10058,1005,3238,2184,0,17,16502
2022-01-18,2,10056,1165,3173,2410,0,16,16820
2022-01-18,3,10062,1180,3143,2921,0,19,17325
2022-01-18,4,10059,1341,3195,2076,0,18,16689
2022-01-18,5,10059,1954,3453,2063,0,16,17545
2022-01-18,6,10001,2498,3315,1086,0,19,16919
2022-01-18,7,9984,2669,3608,1614,0,27,17902
2022-01-18,8,9978,3050,4173,1603,1,31,18836
2022-01-18,9,9975,3660,4436,1353,2,32,19458
2022-01-18,10,9975,3999,4406,1149,21,32,19582
2022-01-18,11,9973,4416,4285,981,33,32,19720
2022-01-18,12,10030,4732,3974,874,50,32,19692
2022-01-18,13,10046,4952,3848,863,79,31,19819
2022-01-18,14,10042,4466,4010,1054,99,32,19703
2022-01-18,15,10044,3544,4306,1438,77,32,19441
2022-01-18,16,10044,3369,4364,1816,42,32,19667
2022-01-18,17,10046,3424,4778,2324,13,32,20617
2022-01-18,18,10048,3831,5087,2617,0,32,21615
2022-01-18,19,10041,3647,4806,2917,0,31,21442
2022-01-18,20,10042,3362,4331,3199,0,32,20966
2022-01-18,21,10044,3285,3651,3276,0,31,20287
2022-01-18,22,10038,2707,3555,2892,0,32,19224
2022-01-18,23,10043,1464,3436,3345,0,31,18319
2022-01-18,24,10048,486,3338,4148,0,23,18043
2022-01-19,1,9617,278,3190,3846,0,17,16948
2022-01-19,2,9232,187,3111,4255,0,16,16801
2022-01-19,3,9239,136,3150,4251,0,16,16792
2022-01-19,4,9244,250,2929,4318,0,16,16757
2022-01-19,5,9245,651,2910,4173,0,16,16995
2022-01-19,6,9243,1277,3068,3535,0,27,17150
2022-01-19,7,9240,2344,3111,3517,0,36,18248
2022-01-19,8,9240,2376,4002,3927,0,32,19577
2022-01-19,9,9237,2562,4281,3809,1,31,19921
2022-01-19,10,9237,2528,4224,3707,13,32,19741
2022-01-19,11,9233,2703,3996,3872,46,40,19890
2022-01-19,12,9239,2518,3830,3947,80,43,19657
2022-01-19,13,9239,2494,3859,3880,113,38,19623
2022-01-19,14,9235,2589,3716,3647,130,30,19347
2022-01-19,15,9238,2996,3768,3906,88,33,20029
2022-01-19,16,9224,2945,4057,3871,43,31,20171
2022-01-19,17,9227,3238,4751,3936,8,30,21190
2022-01-19,18,9224,4467,4895,3915,0,30,22531
2022-01-19,19,9232,4879,4618,3845,0,31,22605
2022-01-19,20,9233,4434,4367,3978,0,31,22043
2022-01-19,21,9230,4232,4272,3929,0,32,21695
2022-01-19,22,9233,2904,4327,3673,0,32,20169
2022-01-19,23,9228,2600,3692,3437,0,31,18988
2022-01-19,24,9224,2789,3643,3185,0,23,18864
2022-01-20,1,9215,2681,3599,2828,0,17,18340
2022-01-20,2,9214,2970,3553,2376,0,17,18130
2022-01-20,3,9216,3154,3429,2282,0,17,18098
2022-01-20,4,9213,3062,3414,2209,0,17,17915
2022-01-20,5,9214,3304,3529,2016,0,17,18080
2022-01-20,6,9210,3456,3656,2050,0,20,18392
2022-01-20,7,9223,4732,4307,1762,1,26,20051
2022-01-20,8,9223,5756,4831,1481,1,31,21323
2022-01-20,9,9221,5685,4634,1355,49,31,20975
2022-01-20,10,9218,5055,4630,1275,166,31,20375
2022-01-20,11,9214,4838,4708,1149,231,31,20171
2022-01-20,12,9214,5557,4105,989,261,31,20157
2022-01-20,13,9213,4954,3906,837,257,31,19198
2022-01-20,14,9210,4490,4206,812,236,31,18985
2022-01-20,15,9216,4211,4399,906,187,31,18950
2022-01-20,16,9217,4569,4678,847,147,31,19489
2022-01-20,17,9216,5508,5174,682,41,31,20652
2022-01-20,18,9213,6970,5082,573,0,31,21869
2022-01-20,19,9216,7107,5106,529,0,31,21989
2022-01-20,20,9218,6518,5015,675,0,31,21457
2022-01-20,21,9209,6641,4828,623,0,32,21333
2022-01-20,22,9209,6715,4480,551,0,32,20987
2022-01-20,23,9212,6589,3904,658,0,32,20395
2022-01-20,24,9210,6075,3806,633,0,22,19746
2022-01-21,1,9218,6038,3580,604,0,17,19457
2022-01-21,2,9436,5867,3175,633,0,17,19128
2022-01-21,3,9444,5412,3327,565,0,17,18765
2022-01-21,4,9539,5123,3516,519,0,17,18714
2022-01-21,5,9626,5024,3728,501,0,17,18896
2022-01-21,6,9622,5368,3889,468,0,19,19366
2022-01-21,7,9628,5910,4394,519,1,3,20455
2022-01-21,8,9621,6680,4402,583,1,17,21304
2022-01-21,9,9704,6710,4359,598,29,26,21426
2022-01-21,10,9792,6378,4355,581,105,25,21236
2022-01-21,11,9798,6347,4395,526,190,27,21283
2022-01-21,12,9795,6209,4366,468,267,27,21132
2022-01-21,13,9793,6692,4178,431,288,25,21407
2022-01-21,14,9798,6441,3932,470,289,26,20956
2022-01-21,15,9800,6070,3921,547,254,26,20618
2022-01-21,16,9799,5878,4586,666,180,25,21134
2022-01-21,17,9801,5808,5062,807,55,26,21559
2022-01-21,18,9802,6328,5190,1045,1,26,22392
2022-01-21,19,9800,6538,5177,1346,0,28,22889
2022-01-21,20,9801,6568,4926,1564,0,34,22893
2022-01-21,21,9800,6541,4584,1647,0,33,22605
2022-01-21,22,9837,6345,4004,1686,0,27,21899
2022-01-21,23,9897,5825,3523,1859,0,39,21143
2022-01-21,24,9906,4898,3238,1854,0,57,19953
2022-01-22,1,9912,3935,3292,1919,0,62,19120
2022-01-22,2,9914,3682,3233,1925,0,51,18805
2022-01-22,3,9919,3109,3270,1987,0,52,18337
2022-01-22,4,9918,2908,3229,2109,0,51,18215
2022-01-22,5,9919,2701,3350,2182,0,52,18204
2022-01-22,6,9916,2702,3238,2584,0,53,18493
2022-01-22,7,9922,2790,3216,2931,1,52,18912
2022-01-22,8,9918,2839,3468,3137,2,47,19411
2022-01-22,9,9963,2897,3474,2988,36,47,19405
2022-01-22,10,9962,2886,3805,3710,61,47,20471
2022-01-22,11,9960,2713,3834,3955,126,47,20635
2022-01-22,12,9965,2663,3686,4116,143,47,20620
2022-01-22,13,9964,2692,3911,4155,127,47,20896
2022-01-22,14,9967,2558,3870,4214,106,47,20762
2022-01-22,15,9973,2961,3601,4306,60,47,20948
2022-01-22,16,9968,3144,3669,4318,34,47,21180
2022-01-22,17,9995,3061,4137,4324,8,47,21572
2022-01-22,18,10005,3081,4582,4272,1,47,21988
2022-01-22,19,10008,2918,4729,3977,0,47,21679
2022-01-22,20,10008,2761,4423,4045,0,47,21284
2022-01-22,21,10006,2587,4082,4026,0,47,20748
2022-01-22,22,10004,2417,3763,3866,0,47,20097
2022-01-22,23,10004,2387,3667,3461,0,47,19566
2022-01-22,24,10000,2166,3318,3066,0,47,18597
2022-01-23,1,9999,1420,3046,2510,0,47,17022
2022-01-23,2,9997,1231,3031,2206,0,47,16512
2022-01-23,3,10081,1089,3090,2199,0,47,16506
2022-01-23,4,10207,1210,3393,1702,0,47,16559
2022-01-23,5,10208,1686,3409,1310,0,47,16660
2022-01-23,6,10343,1453,3424,1109,0,47,16376
2022-01-23,7,10536,1691,3660,1015,0,47,16949
2022-01-23,8,10538,1807,3578,948,0,47,16918
2022-01-23,9,10527,2279,3875,978,6,47,17712
2022-01-23,10,10535,3095,4068,917,25,47,18687
2022-01-23,11,10531,3323,3931,985,50,47,18867
2022-01-23,12,10532,3260,3772,1246,70,47,18927
2022-01-23,13,10527,3449,3681,1356,79,47,19139
2022-01-23,14,10534,3427,3552,1323,94,47,18977
2022-01-23,15,10536,3359,3679,1290,86,47,18997
2022-01-23,16,10540,3334,4162,1395,60,47,19538
2022-01-23,17,10534,4027,5294,970,16,47,20888
2022-01-23,18,10537,5499,5332,660,1,47,22076
2022-01-23,19,10535,5776,5245,562,0,47,22165
2022-01-23,20,10569,5604,5146,549,0,47,21915
2022-01-23,21,10682,5390,4902,534,0,49,21557
2022-01-23,22,10683,4983,4358,504,0,49,20577
2022-01-23,23,10677,4675,3836,572,0,49,19809
2022-01-23,24,10682,3845,3400,618,0,50,18595
2022-01-24,1,10680,3614,3631,698,0,50,18673
2022-01-24,2,10679,3470,3440,781,0,49,18419
2022-01-24,3,10686,3305,3377,787,0,49,18204
2022-01-24,4,10694,3220,3239,859,0,51,18063
2022-01-24,5,10691,3197,3319,1146,0,56,18409
2022-01-24,6,10686,3203,3616,1306,0,57,18868
2022-01-24,7,10687,3702,4214,1370,1,57,20031
2022-01-24,8,10686,4515,4569,1483,1,57,21311
2022-01-24,9,10686,4680,4635,1597,8,57,21663
2022-01-24,10,10698,5309,4660,1751,31,56,22505
2022-01-24,11,10772,5388,4533,1952,45,56,22746
2022-01-24,12,10740,5161,4254,2088,65,57,22365
2022-01-24,13,10728,4843,4157,2117,69,56,21970
2022-01-24,14,10731,4797,4280,1903,64,56,21831
2022-01-24,15,10732,5248,4289,1667,46,56,22038
2022-01-24,16,10728,5455,4461,1357,29,56,22086
2022-01-24,17,10725,5703,5044,1065,8,56,22601
2022-01-24,18,10721,5866,5143,847,1,61,22639
2022-01-24,19,10725,6051,5130,759,0,70,22735
2022-01-24,20,10724,5991,4863,833,0,72,22483
2022-01-24,21,10772,6027,4423,949,0,72,22243
2022-01-24,22,10775,5713,4057,1072,0,72,21689
2022-01-24,23,10772,4534,3581,1278,0,72,20237
2022-01-24,24,10773,3141,3355,1549,0,66,18884
2022-01-25,1,10776,2382,3039,1839,0,61,18097
2022-01-25,2,10775,2213,2979,1999,0,60,18026
2022-01-25,3,10734,2220,2994,2146,0,60,18154
2022-01-25,4,10780,2362,2953,2019,0,62,18176
2022-01-25,5,10775,2474,2938,1963,0,61,18211
2022-01-25,6,10773,2641,3348,1765,0,67,18594
2022-01-25,7,10770,2883,3762,2070,0,81,19566
2022-01-25,8,10771,3857,4322,1711,1,78,20740
2022-01-25,9,10771,4963,4271,1592,8,76,21681
2022-01-25,10,10771,4577,4222,1411,56,75,21112
2022-01-25,11,10770,4764,4106,1252,106,78,21076
2022-01-25,12,10764,5140,4056,1060,122,85,21227
2022-01-25,13,10761,5023,3929,1053,139,83,20988
2022-01-25,14,10764,4514,3939,1012,136,84,20449
2022-01-25,15,10768,4514,4032,918,138,84,20454
2022-01-25,16,10757,4601,4246,870,99,86,20659
2022-01-25,17,10754,5144,4724,742,35,89,21488
2022-01-25,18,10745,5999,5058,749,1,81,22633
2022-01-25,19,10746,6192,4946,675,0,74,22633
2022-01-25,20,10748,5855,5020,748,0,78,22449
2022-01-25,21,10743,5681,4955,576,0,74,22029
2022-01-25,22,10744,5473,4373,595,0,75,21260
2022-01-25,23,10738,4105,3983,676,0,74,19576
2022-01-25,24,10747,3418,3750,686,0,69,18670
2022-01-26,1,10742,3427,3709,698,0,67,18643
2022-01-26,2,10740,3681,3480,839,0,60,18800
2022-01-26,3,10739,3400,3471,1088,0,60,18758
2022-01-26,4,10739,3396,3420,1209,0,60,18824
2022-01-26,5,10744,3451,3352,1445,0,59,19051
2022-01-26,6,10749,3547,3711,1357,0,61,19425
2022-01-26,7,10757,4614,4172,1301,0,69,20913
2022-01-26,8,10758,4932,4859,1295,2,73,21919
2022-01-26,9,10755,5541,4908,1292,12,54,22562
2022-01-26,10,10748,5553,4919,978,67,56,22321
2022-01-26,11,10748,5596,4944,561,128,89,22066
2022-01-26,12,10748,5564,4488,407,137,95,21439
2022-01-26,13,10747,5341,4123,374,147,94,20826
2022-01-26,14,10738,4462,4129,371,207,77,19984
2022-01-26,15,10750,4539,4194,526,197,76,20282
2022-01-26,16,10744,4880,4445,735,129,76,21009
2022-01-26,17,10752,4623,4954,1014,33,83,21459
2022-01-26,18,10761,4728,4888,1531,1,92,22001
2022-01-26,19,10775,4660,4768,2100,0,89,22392
2022-01-26,20,10778,4502,4481,2809,0,88,22658
2022-01-26,21,10770,3919,4228,3182,0,81,22180
2022-01-26,22,10769,3874,3875,3310,0,76,21904
2022-01-26,23,10768,2948,3343,3431,0,81,20571
2022-01-26,24,10765,2025,3107,3469,0,68,19434
2022-01-27,1,10763,1199,3175,3451,0,68,18656
2022-01-27,2,10752,997,3048,3389,0,70,18256
2022-01-27,3,10759,1007,3077,3046,0,68,17957
2022-01-27,4,10767,1083,3071,2750,0,65,17736
2022-01-27,5,10764,1384,3038,2649,0,66,17901
2022-01-27,6,10786,1782,3072,2651,0,67,18358
2022-01-27,7,10780,2117,3177,3549,1,77,19701
2022-01-27,8,10779,2107,3635,4220,2,80,20823
2022-01-27,9,10782,2108,3761,4407,15,81,21154
2022-01-27,10,10779,2096,4114,4363,65,83,21500
2022-01-27,11,10784,2081,3875,4338,85,83,21246
2022-01-27,12,10783,2082,3969,4347,90,83,21354
2022-01-27,13,10781,1812,3945,4337,80,82,21037
2022-01-27,14,10785,1962,4053,4309,65,82,21256
2022-01-27,15,10784,2231,3992,4232,56,83,21378
2022-01-27,16,10796,2499,4272,4027,35,82,21711
2022-01-27,17,10801,2920,4663,3673,12,83,22152
2022-01-27,18,10796,3489,4952,3363,1,83,22684
2022-01-27,19,10795,3972,4764,3149,0,83,22763
2022-01-27,20,10793,3409,4182,3209,0,83,21676
2022-01-27,21,10780,3282,3656,3091,0,83,20892
2022-01-27,22,10781,2610,3300,2504,0,82,19277
2022-01-27,23,10768,1698,3159,2572,0,83,18280
2022-01-27,24,10778,1046,3317,2462,0,70,17673
2022-01-28,1,10777,794,3222,2231,0,65,17089
2022-01-28,2,10782,795,3230,1594,0,64,16465
2022-01-28,3,10780,800,3210,1499,0,64,16353
2022-01-28,4,10783,1035,3036,1775,0,64,16693
2022-01-28,5,10785,1536,3133,2081,0,63,17598
2022-01-28,6,10788,1734,3408,2297,0,65,18292
2022-01-28,7,10790,2090,3907,1884,0,76,18747
2022-01-28,8,10787,2365,4554,1982,2,80,19770
2022-01-28,9,10786,3496,4798,1830,14,81,21005
2022-01-28,10,10786,3025,4669,1752,58,81,20371
2022-01-28,11,10787,3317,4516,1566,106,80,20372
2022-01-28,12,10782,2971,4342,1564,167,76,19902
2022-01-28,13,10781,2830,4297,1490,244,69,19711
2022-01-28,14,10781,3007,4159,1462,251,80,19740
2022-01-28,15,10785,3243,4099,1419,238,81,19865
2022-01-28,16,10784,3585,4593,1228,171,82,20443
2022-01-28,17,10781,3974,5473,1159,54,81,21522
2022-01-28,18,10764,5377,5504,1012,2,81,22740
2022-01-28,19,10768,5801,5428,1125,0,81,23203
2022-01-28,20,10784,5435,5308,1201,0,82,22810
2022-01-28,21,10782,5538,4947,1335,0,81,22683
2022-01-28,22,10778,5396,4484,1315,0,82,22055
2022-01-28,23,10781,4937,4345,1135,0,82,21280
2022-01-28,24,10782,4104,4070,1055,0,69,20080
2022-01-29,1,10785,3561,3936,1071,0,51,19404
2022-01-29,2,10786,3177,3886,1136,0,47,19032
2022-01-29,3,10787,2995,3833,1161,0,47,18823
2022-01-29,4,10783,3029,3652,1219,0,47,18730
2022-01-29,5,10782,3075,3820,1103,0,47,18827
2022-01-29,6,10781,3287,3900,1050,0,47,19065
2022-01-29,7,10784,3916,4375,973,2,47,20097
2022-01-29,8,10784,4474,4751,859,2,47,20917
2022-01-29,9,10780,5037,4853,733,43,47,21493
2022-01-29,10,10783,5270,5003,632,140,47,21875
2022-01-29,11,10785,5267,4844,426,212,47,21581
2022-01-29,12,10798,5151,4476,276,240,47,20988
2022-01-29,13,10794,5123,4303,167,252,47,20686
2022-01-29,14,10798,5062,4073,158,256,47,20394
2022-01-29,15,10794,4921,4082,148,241,47,20233
2022-01-29,16,10795,5066,4244,147,175,47,20474
2022-01-29,17,10792,4532,5243,233,68,47,20915
2022-01-29,18,10801,5345,5466,390,3,47,22052
2022-01-29,19,10803,5709,5381,629,0,47,22569
2022-01-29,20,10803,5262,5240,893,0,47,22245
2022-01-29,21,10792,4460,4914,1157,0,47,21370
2022-01-29,22,10803,3797,4342,1382,0,47,20371
2022-01-29,23,10816,3220,3862,1526,0,47,19471
2022-01-29,24,10823,3170,3680,1516,0,47,19236
2022-01-30,1,10822,3066,3360,1383,0,47,18678
2022-01-30,2,10820,3343,2951,1256,0,47,18417
2022-01-30,3,10830,3201,3162,1107,0,47,18347
2022-01-30,4,10825,3290,3205,917,0,47,18284
2022-01-30,5,10823,3471,3207,726,0,47,18274
2022-01-30,6,10815,3375,3219,546,0,47,18002
2022-01-30,7,10824,3739,3350,564,2,47,18526
2022-01-30,8,10818,3420,3637,454,2,47,18378
2022-01-30,9,10829,3362,4299,451,30,47,19018
2022-01-30,10,10831,3413,4079,394,78,47,18842
2022-01-30,11,10833,3325,4421,334,100,47,19060
2022-01-30,12,10826,3473,4284,296,143,47,19069
2022-01-30,13,10828,3524,4150,291,165,47,19005
2022-01-30,14,10831,3447,4135,296,161,47,18917
2022-01-30,15,10829,3816,4106,268,116,47,19182
2022-01-30,16,10826,4154,4330,194,62,47,19613
2022-01-30,17,10840,4610,5108,130,29,47,20764
2022-01-30,18,10855,4989,5439,175,2,47,21507
2022-01-30,19,10863,4698,5424,249,0,47,21281
2022-01-30,20,10863,3951,5222,270,0,47,20353
2022-01-30,21,10863,3356,5117,273,0,47,19656
2022-01-30,22,10860,3260,4775,240,0,47,19182
2022-01-30,23,10855,3392,3945,307,0,47,18546
2022-01-30,24,10848,3136,3528,400,0,47,17959
2022-01-31,1,10850,2997,3261,345,0,51,17504
2022-01-31,2,10844,2964,3295,295,0,66,17464
2022-01-31,3,10846,2966,3354,436,0,67,17669
2022-01-31,4,10843,2977,3401,350,0,67,17638
2022-01-31,5,10850,3083,3454,263,0,67,17717
2022-01-31,6,10849,3208,3677,194,0,70,17998
2022-01-31,7,10848,4378,3989,184,1,76,19476
2022-01-31,8,10851,5367,4314,175,1,81,20789
2022-01-31,9,10851,5700,4379,181,42,81,21234
2022-01-31,10,10849,5778,4405,180,127,74,21413
2022-01-31,11,10849,5545,4266,159,194,47,21060
2022-01-31,12,10844,5059,4033,172,208,47,20363
2022-01-31,13,10843,3784,3882,208,242,59,19018
2022-01-31,14,10844,3564,3701,219,245,73,18646
2022-01-31,15,10847,3432,3873,230,233,80,18695
2022-01-31,16,10858,3525,3855,281,179,82,18780
2022-01-31,17,10856,4068,4528,355,74,82,19963
2022-01-31,18,10854,4914,4830,481,6,82,21167
2022-01-31,19,10861,5053,4780,955,0,81,21730
2022-01-31,20,10859,3991,4751,1641,0,81,21323
2022-01-31,21,10855,3634,4227,2187,0,81,20984
2022-01-31,22,10852,2730,3725,2499,0,81,19887
2022-01-31,23,10849,1771,3437,2103,0,80,18240
2022-01-31,24,10845,906,3593,2183,0,71,17598
2022-02-01,1,10845,688,3343,2347,0,68,17291
2022-02-01,2,10839,275,3301,2507,0,66,16988
2022-02-01,3,10835,139,3380,2496,0,66,16916
2022-02-01,4,10836,314,3344,2251,0,66,16811
2022-02-01,5,10848,595,3303,2290,0,67,17103
2022-02-01,6,10850,824,3408,2419,0,67,17568
2022-02-01,7,10844,956,3480,3456,1,75,18812
2022-02-01,8,10848,963,3878,3809,5,81,19584
2022-02-01,9,10843,955,3916,3941,50,81,19786
2022-02-01,10,10844,960,3859,3677,132,82,19554
2022-02-01,11,10838,959,3704,3503,223,82,19309
2022-02-01,12,10833,832,3705,3492,253,82,19197
2022-02-01,13,10835,455,3710,3021,243,82,18346
2022-02-01,14,10839,245,3744,3105,234,82,18249
2022-02-01,15,10839,545,3778,3179,191,82,18614
2022-02-01,16,10847,797,3682,2841,127,82,18376
2022-02-01,17,10850,891,4166,3606,54,46,19613
2022-02-01,18,10853,950,4502,3951,2,35,20293
2022-02-01,19,10848,1005,4521,4109,0,36,20519
2022-02-01,20,10842,923,4012,4358,0,36,20171
2022-02-01,21,10836,867,3810,4434,0,36,19983
2022-02-01,22,10836,417,3842,4403,0,36,19534
2022-02-01,23,10838,294,3615,4059,0,35,18841
2022-02-01,24,10843,139,3537,3345,0,24,17888
2022-02-02,1,10845,134,3565,1719,0,19,16282
2022-02-02,2,10841,135,3412,1918,0,19,16325
2022-02-02,3,10850,175,3353,1955,0,19,16352
2022-02-02,4,10853,245,3495,1723,0,19,16335
2022-02-02,5,10856,427,3595,1590,0,19,16487
2022-02-02,6,10858,777,3417,1234,0,24,16310
2022-02-02,7,10857,1292,3409,1130,0,31,16719
2022-02-02,8,10856,1547,3772,1236,5,34,17450
2022-02-02,9,10852,1926,4199,1104,42,34,18157
2022-02-02,10,10847,1814,4099,873,87,34,17754
2022-02-02,11,10855,2144,4131,884,122,34,18170
2022-02-02,12,10861,2097,4434,1086,127,34,18639
2022-02-02,13,10862,2072,4716,1230,106,34,19020
2022-02-02,14,10855,2106,4318,1593,75,34,18981
2022-02-02,15,10857,1806,4383,1738,49,34,18867
2022-02-02,16,10856,1773,4354,1945,33,34,18995
2022-02-02,17,10857,1768,4072,2526,12,33,19268
2022-02-02,18,10857,1791,4431,2906,1,33,20019
2022-02-02,19,10856,1747,4394,2969,0,34,20000
2022-02-02,20,10852,1230,4499,2835,0,35,19451
2022-02-02,21,10851,1069,4430,2764,0,35,19149
2022-02-02,22,10848,839,4141,2903,0,36,18767
2022-02-02,23,10846,372,3967,3002,0,36,18223
2022-02-02,24,10850,214,4083,2894,0,29,18070
2022-02-03,1,10832,149,3788,2908,0,20,17697
2022-02-03,2,10846,134,3827,2873,0,19,17699
2022-02-03,3,10850,135,3719,2641,0,18,17363
2022-02-03,4,10851,155,3785,2430,0,18,17239
2022-02-03,5,10851,281,3763,2545,0,19,17459
2022-02-03,6,10857,465,3669,2084,0,15,17090
2022-02-03,7,10863,814,3512,2112,0,32,17333
2022-02-03,8,10864,918,3872,2207,0,47,17908
2022-02-03,9,10858,977,4384,2666,8,44,18937
2022-02-03,10,10852,1086,4576,2751,30,41,19336
2022-02-03,11,10850,1173,4565,2841,41,38,19508
2022-02-03,12,10842,1429,4395,2880,42,35,19623
2022-02-03,13,10834,1548,4111,3062,41,36,19632
2022-02-03,14,10836,1280,3910,3375,41,36,19478
2022-02-03,15,10840,1432,3706,3178,39,43,19238
2022-02-03,16,10841,1546,3758,3314,34,47,19540
2022-02-03,17,10836,1558,4613,3413,13,46,20479
2022-02-03,18,10839,1761,4971,3315,0,50,20936
2022-02-03,19,10844,2074,4900,3168,0,47,21033
2022-02-03,20,10844,2398,4692,2955,0,48,20937
2022-02-03,21,10843,2435,4394,2935,0,50,20657
2022-02-03,22,10847,1857,4000,3001,0,51,19756
2022-02-03,23,10846,789,3774,3026,0,55,18490
2022-02-03,24,10847,578,3712,2920,0,44,18101
2022-02-04,1,10842,583,3745,2944,0,32,18146
2022-02-04,2,10849,700,4077,2853,0,24,18503
2022-02-04,3,10852,1051,4077,2779,0,21,18780
2022-02-04,4,10850,1480,4082,2530,0,20,18962
2022-02-04,5,10848,1882,3948,2417,0,20,19115
2022-02-04,6,10855,2184,3684,2119,0,22,18864
2022-02-04,7,10844,3221,4222,2007,0,32,20326
2022-02-04,8,10844,4571,4395,1896,0,36,21742
2022-02-04,9,10840,5218,4757,1490,4,36,22345
2022-02-04,10,10845,5589,4699,1125,17,39,22314
2022-02-04,11,10838,5673,4786,890,35,40,22262
2022-02-04,12,10845,5509,4578,729,33,36,21730
2022-02-04,13,10835,5640,4429,618,34,36,21592
2022-02-04,14,10818,5793,4231,553,37,36,21468
2022-02-04,15,10807,5648,4261,513,29,36,21294
2022-02-04,16,10799,5237,4736,470,27,36,21305
2022-02-04,17,10800,5138,4741,422,13,36,21150
2022-02-04,18,10807,5328,4984,373,1,36,21529
2022-02-04,19,10699,5807,4754,441,0,36,21737
2022-02-04,20,10468,5533,4641,527,0,36,21205
2022-02-04,21,10057,5972,4562,613,0,36,21240
2022-02-04,22,10021,5942,4467,682,0,35,21147
2022-02-04,23,10028,5541,4408,624,0,35,20636
2022-02-04,24,10024,5162,4120,461,0,18,19785
2022-02-05,1,10018,4544,4185,417,0,1,19165
2022-02-05,2,10015,3978,4141,526,0,0,18660
2022-02-05,3,10023,3160,4156,583,0,0,17922
2022-02-05,4,10019,3607,4081,557,0,0,18264
2022-02-05,5,10023,3727,4018,651,0,0,18419
2022-02-05,6,10019,3388,4077,777,0,0,18261
2022-02-05,7,10025,3842,4119,839,1,3,18829
2022-02-05,8,10026,4256,4472,837,1,1,19593
2022-02-05,9,10026,5036,4471,721,14,0,20268
2022-02-05,10,10022,5344,4505,481,45,0,20397
2022-02-05,11,10023,5663,4594,278,65,0,20623
2022-02-05,12,10022,5635,4215,187,78,0,20137
2022-02-05,13,10020,5352,4187,135,89,0,19783
2022-02-05,14,10015,4521,4127,140,98,0,18901
2022-02-05,15,10028,4013,4108,176,96,0,18421
2022-02-05,16,10028,3890,4507,316,72,0,18813
2022-02-05,17,10029,4221,4810,583,20,0,19663
2022-02-05,18,10014,4574,4978,919,3,0,20488
2022-02-05,19,10024,5071,4855,1387,0,0,21337
2022-02-05,20,10028,4300,4685,1964,0,0,20977
2022-02-05,21,10021,3389,4503,2224,0,0,20137
2022-02-05,22,10024,2777,4013,2497,0,0,19311
2022-02-05,23,10021,2015,3653,2612,0,0,18301
2022-02-05,24,10025,1153,3703,3176,0,0,18057
2022-02-06,1,10027,994,3489,3099,0,0,17609
2022-02-06,2,10024,800,3560,3256,0,0,17640
2022-02-06,3,10029,761,3452,3191,0,0,17433
2022-02-06,4,10036,752,3420,3712,0,0,17920
2022-02-06,5,10032,833,3551,3846,0,0,18262
2022-02-06,6,10034,1042,3476,3411,0,0,17963
2022-02-06,7,10037,1379,3528,3399,1,0,18344
2022-02-06,8,10039,1528,3642,3852,2,0,19063
2022-02-06,9,10038,1539,3769,4043,15,0,19404
2022-02-06,10,10040,1592,4099,4049,50,0,19830
2022-02-06,11,10040,1783,3975,4025,75,0,19898
2022-02-06,12,10037,1929,3822,3956,97,0,19841
2022-02-06,13,10041,1909,3443,3834,109,0,19336
2022-02-06,14,10047,1547,3507,3711,120,0,18932
2022-02-06,15,10003,1766,3576,3352,133,0,18830
2022-02-06,16,10047,1942,3661,3067,116,0,18833
2022-02-06,17,10042,2270,4239,3079,61,0,19691
2022-02-06,18,10043,2621,4740,3252,7,0,20663
2022-02-06,19,10040,2726,4578,3364,0,0,20708
2022-02-06,20,10037,2451,4372,3494,0,0,20354
2022-02-06,21,10044,2302,3966,3367,0,0,19679
2022-02-06,22,10037,1897,3646,3390,0,0,18970
2022-02-06,23,10039,1656,3433,3088,0,0,18216
2022-02-06,24,10039,870,3516,2844,0,0,17269
2022-02-07,1,10035,399,3380,2987,0,4,16805
2022-02-07,2,10037,482,3322,2446,0,9,16296
2022-02-07,3,10044,733,3295,1911,0,10,15993
2022-02-07,4,10043,902,3289,1797,0,11,16042
2022-02-07,5,10050,1313,3293,1442,0,11,16109
2022-02-07,6,10044,2063,3289,1281,0,13,16690
2022-02-07,7,10038,2846,3597,1535,1,22,18039
2022-02-07,8,10040,3152,4308,2095,3,37,19635
2022-02-07,9,10037,3567,4399,2058,26,26,20113
2022-02-07,10,10036,3657,4439,1816,92,26,20066
2022-02-07,11,10046,3698,4341,1638,174,26,19923
2022-02-07,12,10048,3113,4288,1543,234,26,19252
2022-02-07,13,10041,2606,4130,1609,247,26,18659
2022-02-07,14,10047,2392,4001,1568,229,26,18263
2022-02-07,15,10042,2806,3835,1570,201,26,18480
2022-02-07,16,10045,3229,4070,1486,91,26,18947
2022-02-07,17,10047,3640,4688,1299,33,26,19733
2022-02-07,18,10059,4678,4911,1277,4,29,20958
2022-02-07,19,10054,4496,4901,1232,0,28,20711
2022-02-07,20,10053,4605,4711,1188,0,27,20584
2022-02-07,21,10052,3802,4600,1218,0,27,19699
2022-02-07,22,10051,3293,4345,1119,0,27,18835
2022-02-07,23,10054,3019,4182,884,0,27,18166
2022-02-07,24,10053,1950,4163,742,0,17,16925
2022-02-08,1,10053,2111,4025,647,0,12,16848
2022-02-08,2,10053,2188,4073,644,0,11,16969
2022-02-08,3,10056,2172,3900,722,0,12,16862
2022-02-08,4,10055,2154,3575,818,0,12,16614
2022-02-08,5,10048,2168,3617,781,0,12,16626
2022-02-08,6,10054,2336,4025,772,0,15,17202
2022-02-08,7,10016,2707,4312,835,1,31,17902
2022-02-08,8,10004,3401,4456,782,2,36,18681
2022-02-08,9,10005,3403,4486,777,25,37,18733
2022-02-08,10,9945,3311,4494,783,94,41,18668
2022-02-08,11,9938,3002,4561,807,168,43,18519
2022-02-08,12,9989,2782,4517,882,188,49,18407
2022-02-08,13,9889,2609,4184,1172,198,52,18104
2022-02-08,14,9866,2573,4023,1604,182,48,18296
2022-02-08,15,10052,2618,3745,1817,153,47,18432
2022-02-08,16,10066,2695,3764,1740,117,49,18431
2022-02-08,17,10050,2679,4388,1653,60,46,18876
2022-02-08,18,10055,2845,4876,1754,6,47,19583
2022-02-08,19,10060,3355,4832,1782,0,47,20076
2022-02-08,20,10059,2872,4591,2100,0,46,19668
2022-02-08,21,10058,2511,4076,2678,0,48,19371
2022-02-08,22,10058,2097,3661,2912,0,35,18763
2022-02-08,23,10051,1750,3526,3005,0,42,18374
2022-02-08,24,10058,744,3514,2970,0,41,17327
2022-02-09,1,10058,246,3412,2875,0,34,16625
2022-02-09,2,10056,137,3368,3148,0,27,16736
2022-02-09,3,10052,144,3470,2851,0,26,16543
2022-02-09,4,10055,228,3362,2997,0,22,16664
2022-02-09,5,10064,511,3267,2999,0,19,16860
2022-02-09,6,10065,966,3281,2756,0,29,17097
2022-02-09,7,10057,1092,3343,3103,1,36,17632
2022-02-09,8,10057,1162,3718,3891,8,41,18877
2022-02-09,9,10059,1163,3670,3661,52,40,18645
2022-02-09,10,10052,1178,3721,3297,101,37,18386
2022-02-09,11,10055,1191,3641,3599,212,33,18731
2022-02-09,12,10056,868,3725,3042,265,20,17976
2022-02-09,13,10053,826,3836,3135,246,29,18125
2022-02-09,14,10039,762,3804,3290,199,41,18135
2022-02-09,15,10045,779,3813,2872,233,45,17787
2022-02-09,16,10038,1010,3735,3054,123,37,17997
2022-02-09,17,10051,1040,4397,2762,76,9,18335
2022-02-09,18,10051,1158,4542,3306,6,0,19063
2022-02-09,19,10048,1275,4710,3340,0,0,19373
2022-02-09,20,10048,1227,4420,3229,0,11,18935
2022-02-09,21,10047,981,4279,3074,0,24,18405
2022-02-09,22,10041,656,3907,3182,0,27,17813
2022-02-09,23,10043,353,3553,3217,0,27,17193
2022-02-09,24,10042,153,3463,2986,0,19,16663
2022-02-10,1,10037,129,3457,2758,0,14,16395
2022-02-10,2,10038,135,3302,2462,0,12,15949
2022-02-10,3,10035,143,3366,2304,0,11,15859
2022-02-10,4,10036,244,3330,2473,0,12,16095
2022-02-10,5,10034,497,3367,2120,0,12,16030
2022-02-10,6,10039,860,3357,2110,0,15,16381
2022-02-10,7,10038,1113,3655,2298,1,24,17129
2022-02-10,8,10042,1231,4224,2652,1,28,18178
2022-02-10,9,10041,1699,4473,2420,16,26,18675
2022-02-10,10,10039,1678,4345,2510,40,27,18639
2022-02-10,11,10040,1366,4335,2567,71,26,18405
2022-02-10,12,10044,1544,4228,2413,76,26,18331
2022-02-10,13,10042,1804,4078,2479,143,27,18573
2022-02-10,14,10041,1433,3890,2537,117,28,18046
2022-02-10,15,10044,1502,4071,2401,105,27,18150
2022-02-10,16,10043,1580,4191,2558,44,26,18442
2022-02-10,17,10047,1608,4453,2495,16,26,18645
2022-02-10,18,10043,1813,5024,1971,2,26,18879
2022-02-10,19,10048,2622,4931,1845,0,26,19472
2022-02-10,20,10045,2093,4650,2119,0,26,18933
2022-02-10,21,10043,1683,4268,2333,0,26,18353
2022-02-10,22,10045,1508,3935,2492,0,26,18006
2022-02-10,23,10042,1296,3720,2576,0,26,17660
2022-02-10,24,10032,645,3744,2596,0,18,17035
2022-02-11,1,10033,217,3569,2626,0,16,16461
2022-02-11,2,10037,129,3549,2727,0,13,16455
2022-02-11,3,10042,129,3343,3082,0,13,16609
2022-02-11,4,10027,129,3307,3126,0,13,16602
2022-02-11,5,10028,129,3292,3274,0,12,16735
2022-02-11,6,10030,130,3335,3147,0,15,16657
2022-02-11,7,10037,130,3535,3840,1,23,17566
2022-02-11,8,10040,129,3808,4328,6,27,18338
2022-02-11,9,10040,131,3958,4364,38,26,18557
2022-02-11,10,10036,191,4279,4334,92,27,18959
2022-02-11,11,10036,330,3958,4346,82,27,18779
2022-02-11,12,10047,496,4199,4363,80,27,19212
2022-02-11,13,10049,713,4077,4325,99,27,19290
2022-02-11,14,10052,888,4069,4118,83,27,19237
2022-02-11,15,10050,1006,4122,4076,60,27,19341
2022-02-11,16,10048,1124,4129,3997,28,27,19353
2022-02-11,17,10043,1313,4395,3823,11,27,19612
2022-02-11,18,10040,1133,4668,3865,2,27,19735
2022-02-11,19,10042,1005,4758,3852,0,27,19684
2022-02-11,20,10038,932,4485,3861,0,27,19343
2022-02-11,21,10038,957,4500,3877,0,27,19399
2022-02-11,22,10039,485,4224,3840,0,26,18614
2022-02-11,23,10034,197,3750,3851,0,42,17874
2022-02-11,24,10035,129,3429,3577,0,63,17233
2022-02-12,1,10037,129,3367,2989,0,53,16575
2022-02-12,2,10038,129,3065,3057,0,51,16340
2022-02-12,3,10035,129,3117,2679,0,51,16011
2022-02-12,4,10038,129,3088,2578,0,48,15881
2022-02-12,5,10035,129,3068,2628,0,48,15908
2022-02-12,6,10041,129,3380,2909,0,48,16507
2022-02-12,7,10041,141,3474,3610,1,48,17315
2022-02-12,8,10045,155,3789,3730,1,48,17768
2022-02-12,9,10041,188,4028,3658,16,48,17979
2022-02-12,10,10036,376,4279,3425,70,48,18234
2022-02-12,11,10038,817,4546,2926,143,48,18518
2022-02-12,12,10045,1263,4080,2635,178,48,18249
2022-02-12,13,10051,1288,3612,2299,248,48,17546
2022-02-12,14,10061,1621,3750,1759,270,48,17509
2022-02-12,15,10057,2157,3908,1439,222,48,17831
2022-02-12,16,10054,2437,3762,1129,160,48,17590
2022-02-12,17,10058,2536,4589,994,103,48,18328
2022-02-12,18,10064,3327,4864,814,10,48,19127
2022-02-12,19,10063,4238,4640,646,0,48,19635
2022-02-12,20,10063,4246,4465,533,0,48,19355
2022-02-12,21,10063,4156,4161,514,0,48,18942
2022-02-12,22,10057,3809,4100,515,0,48,18529
2022-02-12,23,10050,3090,4024,519,0,48,17731
2022-02-12,24,10048,2628,3972,460,0,48,17156
2022-02-13,1,10052,1901,4060,420,0,15,16448
2022-02-13,2,10056,1757,3976,415,0,0,16204
2022-02-13,3,10055,1914,3891,355,0,0,16215
2022-02-13,4,10054,2373,3958,380,0,0,16765
2022-02-13,5,10049,2297,3848,447,0,0,16641
2022-02-13,6,10050,2538,3953,534,0,0,17075
2022-02-13,7,10048,3265,4112,564,2,0,17991
2022-02-13,8,10050,3642,4427,631,10,0,18760
2022-02-13,9,10052,3704,4334,516,76,0,18682
2022-02-13,10,10039,3963,4253,284,166,0,18705
2022-02-13,11,10034,4090,4221,168,250,0,18763
2022-02-13,12,10029,4411,4025,151,323,0,18939
2022-02-13,13,10038,4708,4031,99,328,0,19204
2022-02-13,14,10035,4978,3910,56,251,0,19230
2022-02-13,15,10038,4838,3918,39,216,0,19049
2022-02-13,16,10040,4604,4284,110,173,0,19211
2022-02-13,17,10041,5219,4480,166,74,0,19980
2022-02-13,18,10043,5810,4875,221,8,0,20957
2022-02-13,19,10038,6068,4901,370,0,0,21377
2022-02-13,20,10035,5747,4881,494,0,0,21157
2022-02-13,21,10036,5461,4706,628,0,0,20831
2022-02-13,22,10039,5635,4433,748,0,0,20855
2022-02-13,23,10036,4890,3900,928,0,0,19754
2022-02-13,24,10035,4474,3855,893,0,0,19257
2022-02-14,1,10035,4021,3762,731,0,0,18549
2022-02-14,2,10034,4251,3754,658,0,8,18705
2022-02-14,3,10040,4518,3822,578,0,10,18968
2022-02-14,4,10039,4785,3777,448,0,10,19059
2022-02-14,5,10038,4893,3819,463,0,10,19223
2022-02-14,6,10036,5005,3950,516,0,13,19520
2022-02-14,7,10040,5133,4368,489,2,21,20053
2022-02-14,8,10033,5416,4668,509,17,26,20669
2022-02-14,9,10031,5675,4647,440,124,27,20944
2022-02-14,10,10031,5966,4555,278,241,27,21098
2022-02-14,11,10033,6057,4075,199,316,27,20707
2022-02-14,12,10037,5720,4085,208,355,27,20432
2022-02-14,13,10036,5663,4038,317,361,28,20443
2022-02-14,14,10038,5298,3988,429,341,29,20123
2022-02-14,15,10036,4377,4143,475,294,27,19352
2022-02-14,16,10033,5216,4242,449,229,27,20196
2022-02-14,17,10035,5583,4894,381,124,28,21045
2022-02-14,18,10032,6301,4865,375,13,27,21613
2022-02-14,19,10033,6395,4859,565,0,27,21879
2022-02-14,20,10031,6709,4645,823,0,27,22235
2022-02-14,21,10033,6536,4396,1046,0,27,22038
2022-02-14,22,10035,6297,4182,1100,0,27,21641
2022-02-14,23,9611,5636,3913,1228,0,27,20415
2022-02-14,24,9197,5162,3978,1363,0,15,19715
2022-02-15,1,9159,3820,4011,1654,0,10,18654
2022-02-15,2,9161,3508,4095,1751,0,10,18525
2022-02-15,3,9159,4005,3943,1737,0,10,18854
2022-02-15,4,9161,3817,4077,1735,0,10,18800
2022-02-15,5,9160,3961,4146,1588,0,10,18865
2022-02-15,6,9166,4267,4279,1319,0,12,19043
2022-02-15,7,9163,5413,4597,1035,2,21,20231
2022-02-15,8,9160,6160,4940,758,10,28,21056
2022-02-15,9,9159,6610,4888,384,78,27,21146
2022-02-15,10,9161,6421,4662,184,235,27,20690
2022-02-15,11,9161,6372,4537,73,334,27,20504
2022-02-15,12,9165,5606,4396,56,365,27,19615
2022-02-15,13,9160,4984,4294,94,332,27,18891
2022-02-15,14,9163,3988,4195,155,355,27,17883
2022-02-15,15,9170,3731,4257,207,369,27,17761
2022-02-15,16,9174,3710,4528,286,300,27,18025
2022-02-15,17,9172,4981,4609,346,151,27,19286
2022-02-15,18,9163,6357,4786,525,16,27,20874
2022-02-15,19,9160,6227,4872,1173,0,27,21459
2022-02-15,20,9163,5566,4920,2008,0,27,21684
2022-02-15,21,9152,4740,4812,2691,0,27,21422
2022-02-15,22,9155,3653,4564,3257,0,28,20657
2022-02-15,23,9158,2423,3866,3488,0,45,18980
2022-02-15,24,9166,1470,3724,3695,0,60,18115
2022-02-16,1,9157,871,3228,2979,0,60,16295
2022-02-16,2,9162,572,3162,2665,0,60,15621
2022-02-16,3,9158,514,3150,2775,0,60,15657
2022-02-16,4,9160,520,3133,3000,0,60,15873
2022-02-16,5,9163,764,3047,3326,0,59,16359
2022-02-16,6,9166,1216,3054,3974,0,62,17472
2022-02-16,7,9168,1713,3458,4369,2,68,18778
2022-02-16,8,9167,2578,3806,4358,8,73,19990
2022-02-16,9,9167,3108,3752,4387,62,74,20550
2022-02-16,10,9169,2624,3774,4297,163,74,20101
2022-02-16,11,9170,2113,3622,4166,202,74,19347
2022-02-16,12,9166,1733,3200,3566,242,75,17982
2022-02-16,13,9164,1324,3276,4040,248,73,18125
2022-02-16,14,9165,1167,3285,4183,229,74,18103
2022-02-16,15,9167,1319,3603,4172,146,74,18481
2022-02-16,16,9166,1109,3584,4244,68,75,18246
2022-02-16,17,9170,1133,3632,4270,16,74,18295
2022-02-16,18,9170,1181,4202,4294,2,73,18922
2022-02-16,19,9170,1171,4148,4219,1,74,18783
2022-02-16,20,9168,963,4356,4332,0,75,18894
2022-02-16,21,9167,815,4240,4287,0,74,18583
2022-02-16,22,9164,588,3828,4340,0,75,17995
2022-02-16,23,9164,355,3390,4328,0,74,17311
2022-02-16,24,9153,137,3111,4183,0,65,16649
2022-02-17,1,9152,138,3219,3846,0,59,16414
2022-02-17,2,9156,136,3354,3904,0,60,16610
2022-02-17,3,9164,135,3611,3656,0,59,16625
2022-02-17,4,9162,150,3813,3213,0,60,16398
2022-02-17,5,9165,353,3887,3271,0,60,16736
2022-02-17,6,9168,490,3752,3049,0,62,16521
2022-02-17,7,9169,878,4401,2646,0,68,17162
2022-02-17,8,9174,1037,4259,3047,1,74,17592
2022-02-17,9,9165,1003,4442,2558,6,74,17248
2022-02-17,10,9164,1493,4579,2388,18,74,17716
2022-02-17,11,9158,1122,4252,2919,30,74,17555
2022-02-17,12,9156,1341,4574,2424,45,74,17614
2022-02-17,13,9160,1916,4699,2045,34,74,17928
2022-02-17,14,9162,2151,4690,1672,39,74,17788
2022-02-17,15,9169,2400,4522,1766,40,74,17971
2022-02-17,16,9168,2488,4374,1795,23,74,17922
2022-02-17,17,9176,2500,4473,1852,9,73,18083
2022-02-17,18,9174,2681,4803,1729,2,74,18463
2022-02-17,19,9189,2812,4753,1664,0,74,18492
2022-02-17,20,9185,2639,4613,1708,0,75,18220
2022-02-17,21,9184,2742,4449,1845,0,75,18295
2022-02-17,22,9186,2606,4216,2021,0,74,18103
2022-02-17,23,9181,1803,3935,2134,0,74,17127
2022-02-17,24,9182,867,4000,2105,0,66,16220
2022-02-18,1,9187,587,3838,2065,0,60,15737
2022-02-18,2,9184,841,3891,1909,0,59,15884
2022-02-18,3,9176,1037,3917,1846,0,59,16035
2022-02-18,4,9177,1114,3948,1808,0,58,16105
2022-02-18,5,9177,1136,3633,1788,0,58,15792
2022-02-18,6,9181,1497,3585,1623,0,61,15947
2022-02-18,7,9180,2026,4020,1479,1,70,16776
2022-02-18,8,9179,2651,4731,1413,2,74,18050
2022-02-18,9,9177,3230,4762,1236,25,75,18505
2022-02-18,10,9177,3559,4661,1035,57,75,18564
2022-02-18,11,9178,3497,4652,908,103,73,18411
2022-02-18,12,9179,3607,4797,696,140,73,18492
2022-02-18,13,9176,3661,4654,575,159,75,18300
2022-02-18,14,9181,3640,4292,674,208,74,18069
2022-02-18,15,9184,2530,4381,932,195,75,17297
2022-02-18,16,9179,2375,4098,1237,126,74,17089
2022-02-18,17,9173,2341,4709,1658,64,74,18019
2022-02-18,18,9177,2383,5040,2053,12,75,18740
2022-02-18,19,9177,2765,5025,2532,0,75,19574
2022-02-18,20,9175,2753,4882,2722,0,73,19605
2022-02-18,21,9174,3208,4617,2728,0,74,19801
2022-02-18,22,9176,3005,4297,3026,0,73,19577
2022-02-18,23,9177,2766,3975,3068,0,74,19060
2022-02-18,24,9178,1974,3877,3376,0,65,18470
2022-02-19,1,9174,1329,3603,3638,0,53,17797
2022-02-19,2,9176,857,3774,3786,0,47,17640
2022-02-19,3,9181,776,3773,3802,0,47,17579
2022-02-19,4,9183,792,3753,3740,0,47,17515
2022-02-19,5,9181,695,3693,3772,0,47,17388
2022-02-19,6,9186,662,3771,3853,0,47,17519
2022-02-19,7,9186,851,3919,3893,1,47,17897
2022-02-19,8,9183,1059,4332,4023,4,48,18649
2022-02-19,9,9185,984,4384,4040,60,48,18701
2022-02-19,10,9168,948,4331,4025,152,47,18671
2022-02-19,11,9167,997,4252,3968,221,47,18652
2022-02-19,12,9169,1167,4454,3949,276,47,19062
2022-02-19,13,9174,1245,4186,4014,296,48,18963
2022-02-19,14,9167,1291,4093,3899,221,48,18719
2022-02-19,15,9167,1784,3891,3758,249,47,18896
2022-02-19,16,9170,2014,3898,3162,191,49,18484
2022-02-19,17,9169,2151,4144,3189,108,48,18809
2022-02-19,18,9167,2763,4874,2787,24,47,19662
2022-02-19,19,9164,3588,4861,2117,0,47,19777
2022-02-19,20,9165,3926,4725,2058,0,47,19921
2022-02-19,21,9165,3756,4465,2284,0,47,19717
2022-02-19,22,9165,3116,4223,2293,0,47,18844
2022-02-19,23,9168,2465,4025,2114,0,48,17820
2022-02-19,24,9168,2251,4076,1981,0,48,17524
2022-02-20,1,9164,1808,4153,2225,0,48,17398
2022-02-20,2,9165,1303,3908,2662,0,47,17085
2022-02-20,3,9163,1209,3658,2876,0,47,16953
2022-02-20,4,9161,1136,3449,2724,0,48,16518
2022-02-20,5,9162,804,3300,3295,0,48,16609
2022-02-20,6,9170,344,3198,3591,0,48,16351
2022-02-20,7,9169,271,3407,3983,1,47,16878
2022-02-20,8,9170,272,3553,4225,7,48,17275
2022-02-20,9,9168,272,3665,4410,43,48,17606
2022-02-20,10,9168,272,3912,4411,124,48,17935
2022-02-20,11,9161,272,3769,4371,203,53,17829
2022-02-20,12,9159,286,3473,4380,321,57,17676
2022-02-20,13,9166,335,3394,4226,305,57,17483
2022-02-20,14,9170,516,3531,4183,282,59,17741
2022-02-20,15,9169,910,3398,3839,286,58,17660
2022-02-20,16,9172,921,3456,3577,264,57,17447
2022-02-20,17,9170,922,3729,3816,153,54,17844
2022-02-20,18,9175,918,4036,4079,27,47,18282
2022-02-20,19,9172,918,3984,4443,0,47,18564
2022-02-20,20,9169,918,4043,4462,0,47,18639
2022-02-20,21,9170,971,3998,4372,0,48,18559
2022-02-20,22,9172,346,4081,4173,0,48,17820
2022-02-20,23,9168,262,3948,3721,0,47,17146
2022-02-20,24,9173,266,3885,3245,0,47,16616
2022-02-21,1,9168,244,3645,2829,0,47,15933
2022-02-21,2,9165,277,3654,2586,0,47,15729
2022-02-21,3,9167,189,3485,2205,0,47,15093
2022-02-21,4,9172,265,3680,1897,0,47,15061
2022-02-21,5,9168,495,3811,1541,0,47,15062
2022-02-21,6,9166,824,3600,1325,0,47,14962
2022-02-21,7,9167,1357,3981,1063,2,47,15617
2022-02-21,8,9166,1746,4445,748,13,48,16166
2022-02-21,9,9164,2192,4256,649,80,48,16389
2022-02-21,10,9166,2209,4216,579,180,48,16398
2022-02-21,11,9164,2097,3798,564,264,48,15935
2022-02-21,12,9166,2124,3668,630,295,47,15930
2022-02-21,13,9166,1792,3559,579,305,48,15449
2022-02-21,14,9170,1767,3654,807,308,48,15754
2022-02-21,15,9172,1975,3677,599,272,47,15742
2022-02-21,16,9171,2111,3725,410,187,47,15651
2022-02-21,17,9171,2117,4294,581,60,48,16271
2022-02-21,18,9168,2064,4497,1532,14,48,17323
2022-02-21,19,9170,1600,4919,2285,0,47,18021
2022-02-21,20,9168,1164,4503,2745,0,48,17628
2022-02-21,21,9169,944,4065,3039,0,48,17265
2022-02-21,22,9173,1000,4171,3068,0,48,17460
2022-02-21,23,9172,724,4153,3163,0,48,17260
2022-02-21,24,9175,453,3888,3155,0,48,16719
2022-02-22,1,9168,166,3798,3119,0,48,16299
2022-02-22,2,9164,131,3627,3189,0,54,16165
2022-02-22,3,9161,132,3473,3281,0,57,16104
2022-02-22,4,9160,144,3548,3271,0,57,16180
2022-02-22,5,9159,290,3802,3338,0,58,16647
2022-02-22,6,9161,449,3345,3397,0,62,16414
2022-02-22,7,9158,852,4158,3292,0,73,17533
2022-02-22,8,9160,1651,4385,3213,6,75,18490
2022-02-22,9,9161,1774,4481,3352,25,74,18867
2022-02-22,10,9139,1734,4357,3319,45,74,18668
2022-02-22,11,9099,1781,4456,3200,50,74,18660
2022-02-22,12,9110,1596,4251,3427,47,74,18505
2022-02-22,13,9105,1391,4312,3610,43,74,18535
2022-02-22,14,9101,1118,4560,3599,31,74,18483
2022-02-22,15,9105,1148,4754,3427,23,75,18532
2022-02-22,16,9105,1419,5161,3103,18,75,18881
2022-02-22,17,9115,1776,5314,2924,11,75,19215
2022-02-22,18,9157,1774,5047,3259,2,75,19314
2022-02-22,19,9164,1439,4982,3420,0,74,19079
2022-02-22,20,9173,1385,4897,3294,0,74,18823
2022-02-22,21,9166,1280,4798,3062,0,75,18381
2022-02-22,22,9164,1147,4405,2972,0,75,17763
2022-02-22,23,9165,907,3875,2957,0,74,16978
2022-02-22,24,9168,518,3188,3197,0,68,16139
2022-02-23,1,9165,227,3030,3322,0,59,15803
2022-02-23,2,9167,139,3447,3069,0,58,15880
2022-02-23,3,9165,244,3861,2856,0,56,16182
2022-02-23,4,9143,195,3460,2921,0,57,15776
2022-02-23,5,9132,258,3076,2905,0,57,15428
2022-02-23,6,9139,393,3182,2914,0,60,15688
2022-02-23,7,9137,609,3515,2906,0,69,16236
2022-02-23,8,9133,1096,4584,3225,4,74,18116
2022-02-23,9,9152,1323,4776,3177,43,75,18546
2022-02-23,10,9155,1480,4833,3381,103,74,19026
2022-02-23,11,9151,1180,4707,3373,204,74,18689
2022-02-23,12,9154,1108,4499,3182,272,74,18289
2022-02-23,13,9151,1228,4467,3258,233,75,18412
2022-02-23,14,9150,1462,4389,2984,192,74,18251
2022-02-23,15,9157,1751,4438,2753,189,74,18362
2022-02-23,16,9168,2340,4363,2232,161,74,18338
2022-02-23,17,9170,2615,4747,2092,103,75,18802
2022-02-23,18,9171,3919,5496,1671,22,75,20354
2022-02-23,19,9176,4696,5410,1521,1,75,20879
2022-02-23,20,9173,4149,5511,1256,0,74,20163
2022-02-23,21,9172,4257,5393,1027,0,74,19923
2022-02-23,22,9170,4490,4952,802,0,75,19489
2022-02-23,23,9164,4490,4525,668,0,75,18922
2022-02-23,24,9165,3525,4333,668,0,68,17759
2022-02-24,1,9161,2975,4436,689,0,59,17320
2022-02-24,2,9162,2929,4167,787,0,59,17104
2022-02-24,3,9165,2798,4081,892,0,58,16994
2022-02-24,4,9167,2442,4128,986,0,55,16778
2022-02-24,5,9165,2707,4069,970,0,59,16970
2022-02-24,6,9164,3481,4051,894,0,60,17650
2022-02-24,7,9166,4712,4305,739,1,68,18991
2022-02-24,8,9167,5586,4351,744,31,74,19953
2022-02-24,9,9167,5381,4363,530,137,75,19653
2022-02-24,10,9170,4723,4146,778,297,73,19187
2022-02-24,11,9169,4503,4138,1037,378,74,19299
2022-02-24,12,9171,3616,4058,1216,426,74,18561
2022-02-24,13,9172,3576,4018,1079,430,75,18350
2022-02-24,14,9171,3314,4047,1004,425,75,18036
2022-02-24,15,9171,3201,3966,1140,410,74,17962
2022-02-24,16,9174,3292,3958,1429,335,74,18262
2022-02-24,17,9170,3896,4539,1640,179,74,19498
2022-02-24,18,9170,4163,4522,2196,33,78,20162
2022-02-24,19,9167,4366,4650,2447,0,83,20713
2022-02-24,20,9166,5497,4719,2209,0,74,21665
2022-02-24,21,9164,5817,4676,2250,0,74,21981
2022-02-24,22,9157,5511,4070,2611,0,74,21423
2022-02-24,23,9166,3902,3824,2850,0,75,19817
2022-02-24,24,9163,3471,3752,2769,0,66,19221
2022-02-25,1,9162,2893,3686,3002,0,59,18802
2022-02-25,2,9163,2518,3287,2953,0,59,17980
2022-02-25,3,9169,2490,3484,2934,0,60,18137
2022-02-25,4,9168,2645,3607,2494,0,60,17974
2022-02-25,5,9167,3226,3600,2352,0,59,18404
2022-02-25,6,9158,3842,3633,2107,0,61,18801
2022-02-25,7,9154,4435,4028,2160,0,48,19825
2022-02-25,8,9160,5226,4396,2252,5,53,21092
2022-02-25,9,9162,5472,4446,2248,36,73,21437
2022-02-25,10,9161,6011,4586,1771,56,73,21658
2022-02-25,11,9154,6177,4461,1547,88,73,21500
2022-02-25,12,9154,6219,4335,1480,107,81,21376
2022-02-25,13,9156,5864,3844,1457,182,74,20577
2022-02-25,14,9163,5846,3801,1447,177,73,20507
2022-02-25,15,9174,5578,3895,1334,168,73,20222
2022-02-25,16,9172,5868,4109,1142,183,73,20547
2022-02-25,17,9169,5510,4336,915,119,73,20122
2022-02-25,18,9164,5833,4446,764,28,73,20308
2022-02-25,19,9167,6515,4588,591,0,74,20935
2022-02-25,20,9164,6546,4662,460,0,74,20906
2022-02-25,21,9167,6453,4356,473,0,74,20523
2022-02-25,22,9168,6274,4255,503,0,74,20274
2022-02-25,23,9168,6038,3950,532,0,74,19762
2022-02-25,24,9170,4748,3814,622,0,62,18416
2022-02-26,1,9170,4637,3868,705,0,50,18430
2022-02-26,2,9163,3842,3760,1035,0,47,17847
2022-02-26,3,9163,3538,3747,1351,0,47,17846
2022-02-26,4,9166,3388,3651,1399,0,48,17652
2022-02-26,5,9168,3473,3760,1396,0,47,17844
2022-02-26,6,9168,3526,3846,1450,0,47,18037
2022-02-26,7,9171,3957,3866,1621,1,48,18664
2022-02-26,8,9172,4235,4150,1746,14,48,19365
2022-02-26,9,9168,4103,4046,1904,86,47,19354
2022-02-26,10,9174,3548,3930,2155,136,47,18990
2022-02-26,11,9167,3126,3745,2473,249,47,18807
2022-02-26,12,9174,2278,3266,2847,273,48,17886
2022-02-26,13,9173,2116,3281,3518,204,49,18341
2022-02-26,14,9172,1803,3480,3848,194,49,18546
2022-02-26,15,9165,1918,3498,4017,154,49,18801
2022-02-26,16,9165,2390,3370,3703,105,49,18782
2022-02-26,17,9172,2628,3482,3521,67,51,18921
2022-02-26,18,9170,2616,3613,3989,20,50,19458
2022-02-26,19,9167,2626,3783,4185,0,47,19808
2022-02-26,20,9172,2625,3527,4296,0,48,19668
2022-02-26,21,9174,2296,3407,4429,0,48,19354
2022-02-26,22,9176,1718,3181,4418,0,47,18540
2022-02-26,23,9175,1152,3440,4357,0,47,18171
2022-02-26,24,9178,822,3099,4376,0,48,17523
2022-02-27,1,9183,418,2710,4266,0,47,16624
2022-02-27,2,9178,192,2825,4175,0,47,16417
2022-02-27,3,9182,135,2823,4312,0,48,16500
2022-02-27,4,9182,135,2836,4384,0,48,16585
2022-02-27,5,9174,135,2941,4404,0,48,16702
2022-02-27,6,9171,132,3310,4308,0,48,16969
2022-02-27,7,9173,131,3406,4301,1,47,17059
2022-02-27,8,9175,131,3522,4285,17,48,17178
2022-02-27,9,9173,132,3525,4202,79,48,17159
2022-02-27,10,9177,152,3689,3937,127,47,17129
2022-02-27,11,9176,218,3458,3683,152,47,16734
2022-02-27,12,9180,153,3225,3549,212,47,16366
2022-02-27,13,9172,266,3293,3513,234,49,16527
2022-02-27,14,9166,530,3531,3319,239,48,16833
2022-02-27,15,9147,1356,3586,2898,218,48,17253
2022-02-27,16,9164,2088,3272,2636,192,52,17404
2022-02-27,17,9172,2462,3531,2508,90,49,17812
2022-02-27,18,9174,2850,4065,2573,23,12,18697
2022-02-27,19,9173,3176,4349,2328,1,0,19027
2022-02-27,20,9170,3153,4291,2444,0,0,19058
2022-02-27,21,9167,3100,4057,2466,0,1,18791
2022-02-27,22,9171,2654,3610,2607,0,0,18042
2022-02-27,23,9170,2741,3331,2147,0,0,17389
2022-02-27,24,9174,2973,3222,1453,0,0,16822
2022-02-28,1,9172,3211,3306,1164,0,0,16853
2022-02-28,2,9175,3497,3448,1003,0,0,17123
2022-02-28,3,9173,3375,3454,753,0,0,16755
2022-02-28,4,9174,3868,3555,667,0,0,17264
2022-02-28,5,9171,3472,3630,555,0,15,16843
2022-02-28,6,9172,4187,3759,484,1,17,17620
2022-02-28,7,9172,5785,3967,487,2,24,19437
2022-02-28,8,9171,6095,4118,415,56,26,19881
2022-02-28,9,9168,5426,4175,315,203,27,19314
2022-02-28,10,9169,4615,4282,282,329,27,18704
2022-02-28,11,9172,4550,4073,320,384,28,18527
2022-02-28,12,9173,4719,3762,416,384,27,18481
2022-02-28,13,9172,4763,3620,488,385,26,18454
2022-02-28,14,9171,5234,3678,525,309,26,18943
2022-02-28,15,9170,5176,3659,701,261,27,18994
2022-02-28,16,9177,4981,3704,794,185,23,18864
2022-02-28,17,9173,4937,4194,1088,99,24,19515
2022-02-28,18,9174,5132,4356,1271,25,26,19984
2022-02-28,19,9171,5408,4424,1841,1,25,20870
2022-02-28,20,9171,4838,4476,2332,0,25,20842
2022-02-28,21,9168,4850,4354,2078,0,25,20475
2022-02-28,22,9169,4939,3768,2104,0,27,20007
2022-02-28,23,9177,3601,3479,2371,0,26,18654
2022-02-28,24,9164,2996,3319,2601,0,17,18097
2022-03-01,1,9161,2309,3422,2583,0,13,17488
2022-03-01,2,9172,2232,3395,2558,0,12,17369
2022-03-01,3,9166,2657,3484,2250,0,12,17569
2022-03-01,4,9167,3060,3470,1839,0,12,17548
2022-03-01,5,9161,3691,3336,1826,0,11,18025
2022-03-01,6,9068,3845,3413,2013,0,14,18353
2022-03-01,7,9066,4073,3825,2181,2,7,19154
2022-03-01,8,9066,4687,4140,2195,13,33,20134
2022-03-01,9,9075,5211,4073,2013,45,31,20448
2022-03-01,10,9084,5301,3873,1951,89,27,20325
2022-03-01,11,9179,5424,3749,1816,147,28,20343
2022-03-01,12,9186,5266,3602,1674,194,28,19950
2022-03-01,13,9181,4818,3618,1633,199,28,19477
2022-03-01,14,9183,4439,3747,1654,140,30,19193
2022-03-01,15,9183,4414,3631,1446,130,29,18833
2022-03-01,16,9184,4225,3671,1563,104,27,18774
2022-03-01,17,9181,4384,4082,2000,51,27,19725
2022-03-01,18,9182,4507,4338,2084,21,27,20159
2022-03-01,19,9179,4473,4389,2288,1,26,20356
2022-03-01,20,9176,4124,4569,2019,0,27,19915
2022-03-01,21,9176,4690,4424,1707,0,26,20023
2022-03-01,22,9172,4381,3883,1408,0,26,18870
2022-03-01,23,9172,3563,3701,1082,0,26,17544
2022-03-01,24,9171,3172,3588,841,0,17,16789
2022-03-02,1,9173,2565,3751,608,0,13,16110
2022-03-02,2,9172,2474,3697,363,0,13,15719
2022-03-02,3,9173,2639,3623,271,0,13,15719
2022-03-02,4,9168,2895,3568,357,0,12,16000
2022-03-02,5,9169,2981,3247,229,0,26,15652
2022-03-02,6,9171,3404,3852,255,0,39,16721
2022-03-02,7,9170,4775,4101,299,1,52,18398
2022-03-02,8,9176,5144,4342,294,23,56,19035
2022-03-02,9,9172,5119,4375,234,77,56,19033
2022-03-02,10,9173,4946,4246,440,211,50,19066
2022-03-02,11,9177,3509,3971,663,270,49,17639
2022-03-02,12,9173,2911,3589,1053,320,53,17099
2022-03-02,13,9173,2730,3485,1170,288,58,16904
2022-03-02,14,9174,2745,3873,1191,247,57,17287
2022-03-02,15,9177,3086,3821,1176,200,57,17517
2022-03-02,16,9173,2978,3897,1130,115,55,17348
2022-03-02,17,9172,3586,4384,1050,62,51,18305
2022-03-02,18,9176,4268,4592,1172,11,49,19268
2022-03-02,19,9179,4554,4663,1108,0,45,19549
2022-03-02,20,9180,4304,4575,1437,0,45,19541
2022-03-02,21,9178,3303,4250,2550,0,51,19332
2022-03-02,22,9181,2709,3409,2795,0,54,18148
2022-03-02,23,9178,1855,3215,2326,0,53,16627
2022-03-02,24,9178,1383,3175,2164,0,30,15930
2022-03-03,1,9171,1227,3191,2153,0,10,15752
2022-03-03,2,9170,1230,3203,2352,0,11,15966
2022-03-03,3,9171,1258,3142,2733,0,11,16315
2022-03-03,4,9171,1418,3441,2375,0,11,16416
2022-03-03,5,9174,1810,3443,2062,0,11,16500
2022-03-03,6,9171,2166,3437,1461,0,13,16248
2022-03-03,7,9170,3063,4169,1077,1,23,17503
2022-03-03,8,9170,3689,4383,878,14,49,18183
2022-03-03,9,9166,4008,4309,865,84,48,18480
2022-03-03,10,9165,4034,4335,858,171,42,18605
2022-03-03,11,9164,3853,4069,777,264,51,18178
2022-03-03,12,9164,3171,3833,926,314,43,17451
2022-03-03,13,9166,2758,3639,1264,362,54,17243
2022-03-03,14,9169,2482,3344,1517,388,51,16951
2022-03-03,15,9168,2606,3530,1502,362,45,17213
2022-03-03,16,9172,3108,3515,1162,264,41,17262
2022-03-03,17,9174,3365,3950,1213,185,31,17918
2022-03-03,18,9173,3919,4807,1159,58,27,19143
2022-03-03,19,9175,4906,5035,883,0,27,20026
2022-03-03,20,9174,5311,4891,788,0,27,20191
2022-03-03,21,9176,5346,4645,721,0,27,19915
2022-03-03,22,9179,4810,4259,690,0,27,18965
2022-03-03,23,9177,4278,3880,759,0,27,18121
2022-03-03,24,9178,3256,3773,879,0,16,17102
2022-03-04,1,9178,2969,3569,949,0,12,16677
2022-03-04,2,9177,2509,3506,1298,0,12,16502
2022-03-04,3,9176,2317,3378,1649,0,12,16532
2022-03-04,4,9175,2349,3236,1667,0,12,16439
2022-03-04,5,9181,2577,3338,1547,0,12,16655
2022-03-04,6,9179,3060,3809,1569,1,13,17631
2022-03-04,7,9180,4183,4188,1664,1,19,19235
2022-03-04,8,9179,4394,4641,1609,43,25,19891
2022-03-04,9,9177,4594,4679,1410,150,27,20037
2022-03-04,10,9182,3613,4341,1281,267,27,18711
2022-03-04,11,9183,3125,3879,1546,353,28,18114
2022-03-04,12,9183,2590,3364,1386,398,27,16948
2022-03-04,13,9190,2173,3335,1616,381,27,16722
2022-03-04,14,9188,2207,3396,1649,353,28,16821
2022-03-04,15,9191,2586,3457,1739,315,35,17323
2022-03-04,16,9195,2813,3483,1430,297,39,17257
2022-03-04,17,9193,2891,3952,898,178,42,17154
2022-03-04,18,9189,3000,4439,1101,43,41,17813
2022-03-04,19,9190,3115,4849,944,1,41,18140
2022-03-04,20,9191,3335,4835,831,0,31,18223
2022-03-04,21,9189,3197,4704,754,0,27,17871
2022-03-04,22,9185,3145,4281,647,0,29,17287
2022-03-04,23,9184,2822,3894,586,0,29,16515
2022-03-04,24,9173,2407,3598,535,0,13,15726
2022-03-05,1,9160,1843,3713,490,0,0,15206
2022-03-05,2,9182,1669,3728,463,0,0,15042
2022-03-05,3,9183,1314,3275,628,0,0,14400
2022-03-05,4,9182,950,3283,830,0,0,14245
2022-03-05,5,9181,864,3300,946,0,0,14291
2022-03-05,6,9181,952,3341,1210,0,0,14684
2022-03-05,7,9183,1105,3552,1544,2,0,15386
2022-03-05,8,9180,1243,3754,1738,26,0,15941
2022-03-05,9,9180,1362,3917,1954,77,0,16490
2022-03-05,10,9180,1476,3904,2262,139,0,16961
2022-03-05,11,9171,1477,3703,2086,212,0,16649
2022-03-05,12,9173,1245,3524,2330,231,0,16503
2022-03-05,13,9166,847,3460,2641,269,0,16383
2022-03-05,14,9165,787,3489,2379,276,0,16096
2022-03-05,15,9163,978,3703,2526,282,0,16652
2022-03-05,16,9160,1138,4085,2496,138,0,17017
2022-03-05,17,9165,786,4328,2780,69,0,17128
2022-03-05,18,9159,613,4705,2944,21,0,17442
2022-03-05,19,9160,1022,4870,2751,0,0,17803
2022-03-05,20,9165,1011,4290,2709,0,0,17175
2022-03-05,21,9165,841,3830,2947,0,0,16783
2022-03-05,22,9163,249,3724,3222,0,0,16358
2022-03-05,23,9167,130,3412,3404,0,0,16113
2022-03-05,24,9168,130,3091,3346,0,0,15735
2022-03-06,1,9164,130,3030,3199,0,0,15523
2022-03-06,2,9168,130,2959,3276,0,0,15533
2022-03-06,3,9173,130,3003,3041,0,3,15350
2022-03-06,4,9177,130,3041,3074,0,4,15426
2022-03-06,5,9176,129,3071,2930,0,13,15319
2022-03-06,6,9176,130,3120,3127,0,16,15569
2022-03-06,7,9177,130,3243,3255,0,14,15819
2022-03-06,8,9182,131,3331,3070,14,9,15737
2022-03-06,9,9180,130,3388,3074,110,0,15882
2022-03-06,10,9175,130,3492,2810,205,1,15813
2022-03-06,11,9179,130,3510,2541,355,9,15724
2022-03-06,12,9170,130,3623,2548,359,9,15839
2022-03-06,13,9171,138,3506,3106,308,3,16232
2022-03-06,14,9170,149,3679,2472,290,0,15760
2022-03-06,15,9165,236,3590,2578,290,0,15859
2022-03-06,16,9163,390,3967,3125,214,0,16859
2022-03-06,17,9154,550,4202,3402,119,0,17427
2022-03-06,18,9150,583,4529,3961,35,0,18258
2022-03-06,19,9169,585,4554,3730,0,0,18038
2022-03-06,20,9174,599,4149,3369,0,0,17291
2022-03-06,21,9178,604,4384,2787,0,0,16953
2022-03-06,22,9179,871,4359,2244,0,0,16653
2022-03-06,23,9179,367,4458,1454,0,0,15458
2022-03-06,24,9173,533,4531,730,0,0,14967
2022-03-07,1,9175,629,4126,490,0,0,14420
2022-03-07,2,9182,474,3641,304,0,7,13608
2022-03-07,3,9186,373,3635,253,0,10,13457
2022-03-07,4,9183,573,3822,200,0,10,13788
2022-03-07,5,9185,1093,3519,244,0,10,14051
2022-03-07,6,9185,1646,3396,213,0,13,14453
2022-03-07,7,9181,2122,3949,568,0,22,15842
2022-03-07,8,9181,2653,4547,707,4,27,17119
2022-03-07,9,9176,3326,4689,607,19,27,17844
2022-03-07,10,9175,3250,4709,638,33,27,17832
2022-03-07,11,9172,3195,4531,646,41,27,17612
2022-03-07,12,9188,3749,4559,441,57,27,18021
2022-03-07,13,9179,3790,4356,735,51,27,18138
2022-03-07,14,9177,3320,4086,1460,50,27,18120
2022-03-07,15,9186,2596,3995,1835,56,27,17695
2022-03-07,16,9186,2600,4176,2380,41,27,18410
2022-03-07,17,9180,2910,4515,2598,28,27,19258
2022-03-07,18,9178,3216,4802,2663,8,27,19894
2022-03-07,19,9174,3328,4803,2811,1,27,20144
2022-03-07,20,9177,3307,4917,2634,0,27,20062
2022-03-07,21,9176,2435,4527,2697,0,27,18862
2022-03-07,22,9179,1680,4291,2459,0,27,17636
2022-03-07,23,9177,1031,4097,2269,0,27,16601
2022-03-07,24,9182,822,3836,2385,0,18,16243
2022-03-08,1,9182,523,3760,2612,0,10,16087
2022-03-08,2,9178,518,3613,2697,0,10,16016
2022-03-08,3,9175,597,3423,2820,0,9,16024
2022-03-08,4,9176,775,3772,2356,0,9,16088
2022-03-08,5,9179,1020,3796,1838,0,9,15842
2022-03-08,6,9185,1375,3878,1271,1,13,15723
2022-03-08,7,9190,2039,4148,921,2,20,16320
2022-03-08,8,9190,2540,4411,666,35,8,16850
2022-03-08,9,9186,2773,4476,498,130,24,17087
2022-03-08,10,9188,2801,4321,390,240,27,16967
2022-03-08,11,9187,2694,4082,351,318,27,16659
2022-03-08,12,9187,2264,3959,465,321,27,16223
2022-03-08,13,9192,2148,3815,718,301,27,16201
2022-03-08,14,9189,2101,3537,1041,314,27,16209
2022-03-08,15,9191,2013,3498,1246,291,27,16266
2022-03-08,16,9187,2044,3774,1232,218,27,16482
2022-03-08,17,9187,2119,4162,1342,122,27,16959
2022-03-08,18,9190,2471,4990,1206,27,27,17911
2022-03-08,19,9191,2744,5012,1312,1,27,18287
2022-03-08,20,9194,2883,5090,1352,1,27,18547
2022-03-08,21,9188,3402,4890,1306,0,27,18813
2022-03-08,22,9188,3386,4584,1237,0,27,18422
2022-03-08,23,9185,2327,4143,1310,0,27,16992
2022-03-08,24,9183,1699,3434,1287,0,20,15623
2022-03-09,1,9183,1922,3356,1118,0,10,15589
2022-03-09,2,9186,1917,3344,1383,0,9,15839
2022-03-09,3,8851,2041,3541,1165,0,9,15607
2022-03-09,4,8387,2734,3740,877,0,9,15747
2022-03-09,5,8391,2705,3755,565,0,16,15432
2022-03-09,6,8390,2820,3707,603,0,18,15538
2022-03-09,7,8384,3728,4308,593,1,41,17055
2022-03-09,8,8383,4216,4589,632,21,73,17914
2022-03-09,9,8384,4161,4482,570,69,80,17746
2022-03-09,10,8383,3876,4381,492,142,81,17355
2022-03-09,11,8396,3700,4243,615,183,82,17219
2022-03-09,12,8396,2983,4243,735,228,83,16668
2022-03-09,13,8388,2845,4000,863,266,83,16445
2022-03-09,14,8394,2400,3802,1132,256,81,16065
2022-03-09,15,8386,2447,3686,1143,266,83,16011
2022-03-09,16,8368,2454,3739,1342,239,82,16224
2022-03-09,17,8371,2453,4102,1433,148,82,16589
2022-03-09,18,8366,2457,4555,1900,53,82,17413
2022-03-09,19,8357,2531,5050,1979,0,83,18000
2022-03-09,20,8354,2653,5090,2120,0,83,18300
2022-03-09,21,8355,2157,4822,2314,0,83,17731
2022-03-09,22,8354,2063,4557,2219,0,83,17276
2022-03-09,23,8358,1866,4190,1984,0,38,16436
2022-03-09,24,8350,1981,3792,1798,0,20,15941
2022-03-10,1,8350,1889,4027,1654,0,11,15931
2022-03-10,2,8346,1882,3886,1473,0,10,15597
2022-03-10,3,8344,1885,3856,1505,0,13,15603
2022-03-10,4,8351,2010,4128,1095,0,13,15597
2022-03-10,5,8351,2268,4150,717,0,11,15497
2022-03-10,6,8358,2413,4128,544,1,28,15472
2022-03-10,7,8358,2880,4385,537,3,34,16197
2022-03-10,8,8359,3456,4791,510,49,79,17244
2022-03-10,9,8358,3509,4828,366,110,78,17249
2022-03-10,10,8358,3143,4540,219,217,76,16553
2022-03-10,11,8359,2851,4270,287,309,79,16155
2022-03-10,12,8361,2475,4173,459,370,79,15917
2022-03-10,13,8358,2446,4010,394,385,78,15671
2022-03-10,14,8360,2201,3973,397,353,78,15362
2022-03-10,15,8359,2350,3970,377,345,78,15479
2022-03-10,16,8363,2615,4037,291,261,73,15640
2022-03-10,17,8363,2815,4611,277,158,79,16303
2022-03-10,18,8365,3434,4972,268,56,79,17174
2022-03-10,19,8363,3296,5067,330,1,79,17136
2022-03-10,20,8365,3436,5203,400,1,79,17484
2022-03-10,21,8362,3925,5019,291,0,81,17678
2022-03-10,22,8363,4114,4611,226,0,79,17393
2022-03-10,23,8365,3695,4216,192,0,39,16507
2022-03-10,24,8362,3002,3972,140,0,19,15495
2022-03-11,1,8363,2310,3985,119,0,10,14787
2022-03-11,2,8365,2091,3975,112,0,10,14553
2022-03-11,3,8371,2194,3952,165,0,10,14692
2022-03-11,4,8377,2280,3864,275,0,10,14806
2022-03-11,5,8390,2371,3698,342,0,12,14813
2022-03-11,6,8397,2515,3960,294,1,28,15195
2022-03-11,7,8397,3035,4420,320,3,68,16243
2022-03-11,8,8397,3914,4722,309,35,76,17453
2022-03-11,9,8396,4178,4739,272,107,76,17768
2022-03-11,10,8396,4099,4544,231,209,76,17555
2022-03-11,11,8396,3698,4612,229,210,76,17221
2022-03-11,12,8397,3533,4886,243,189,76,17324
2022-03-11,13,8399,3713,4641,304,158,76,17291
2022-03-11,14,8401,3527,4310,443,133,76,16890
2022-03-11,15,8399,3305,4314,448,91,76,16633
2022-03-11,16,8395,3157,4441,521,57,76,16647
2022-03-11,17,8392,3383,4731,586,33,76,17201
2022-03-11,18,8393,3260,4901,884,11,76,17525
2022-03-11,19,8394,3164,5007,1158,0,78,17801
2022-03-11,20,8394,2683,5034,1289,0,78,17478
2022-03-11,21,8393,2323,4897,1496,0,77,17186
2022-03-11,22,8396,2197,4356,1892,0,78,16919
2022-03-11,23,8393,1282,4337,2201,0,37,16250
2022-03-11,24,8388,661,3736,2974,0,14,15773
2022-03-12,1,8390,160,3245,3240,0,6,15041
2022-03-12,2,8385,131,3231,3285,0,0,15032
2022-03-12,3,8379,130,3189,3485,0,0,15183
2022-03-12,4,8356,144,3159,3590,0,0,15249
2022-03-12,5,8356,150,3245,3767,0,0,15518
2022-03-12,6,8360,235,3280,3535,0,0,15410
2022-03-12,7,8361,416,3442,3412,1,0,15632
2022-03-12,8,8366,544,3668,3570,7,0,16155
2022-03-12,9,8362,676,4141,3632,27,0,16838
2022-03-12,10,8360,810,4141,3670,65,0,17046
2022-03-12,11,8360,815,3870,3726,101,0,16872
2022-03-12,12,8360,868,3761,3766,135,0,16890
2022-03-12,13,8359,842,3432,3849,157,0,16639
2022-03-12,14,8359,1066,3215,3918,157,0,16715
2022-03-12,15,8356,1509,3133,3879,181,0,17058
2022-03-12,16,8352,1802,3250,4100,124,0,17628
2022-03-12,17,8353,1889,3429,3641,66,0,17378
2022-03-12,18,8353,1965,3572,3841,27,0,17758
2022-03-12,19,8356,1974,3981,4033,1,0,18345
2022-03-12,20,8356,2037,3983,3950,0,0,18326
2022-03-12,21,8357,2045,3782,3856,0,0,18040
2022-03-12,22,8357,1484,3839,3714,0,0,17394
2022-03-12,23,8356,1212,3748,3424,0,0,16740
2022-03-12,24,8354,774,3826,2981,0,0,15935
2022-03-13,1,8356,898,3683,2590,0,0,15527
2022-03-13,2,8357,781,3533,2380,0,0,15051
2022-03-13,3,8350,612,3446,2130,0,0,14538
2022-03-13,4,8353,623,3712,2081,0,0,14769
2022-03-13,5,8352,742,3601,2216,0,0,14911
2022-03-13,6,8354,777,3506,2450,1,0,15088
2022-03-13,7,8355,740,3607,2858,3,0,15563
2022-03-13,8,8353,730,3734,3099,10,0,15926
2022-03-13,9,8346,785,3882,3453,34,0,16500
2022-03-13,10,8351,796,3740,3730,78,0,16695
2022-03-13,11,8349,803,3891,3807,114,0,16964
2022-03-13,12,8350,989,3802,3734,171,0,17046
2022-03-13,13,8349,997,3603,3660,156,0,16765
2022-03-13,14,8353,1151,3420,3532,118,0,16574
2022-03-13,15,8348,1342,3593,3266,124,0,16673
2022-03-13,16,8355,1745,4097,2811,82,0,17090
2022-03-13,17,8356,2466,4166,2292,47,0,17327
2022-03-13,18,8399,3120,4202,2031,17,0,17769
2022-03-13,19,8585,2965,4402,1992,2,0,17946
2022-03-13,20,8591,2605,4384,2070,0,0,17650
2022-03-13,21,8718,2119,4238,2068,0,0,17143
2022-03-13,22,8809,1920,3852,2155,0,0,16736
2022-03-13,23,8810,1515,3634,1872,0,0,15831
2022-03-13,24,8881,942,3922,1401,0,0,15146
2022-03-14,1,8891,1114,4190,1097,0,0,15292
2022-03-14,2,8888,1043,3772,1033,0,0,14736
2022-03-14,3,8885,949,3734,1007,0,0,14575
2022-03-14,4,8891,1268,3660,1077,0,0,14896
2022-03-14,5,8901,1729,3587,1103,0,12,15332
2022-03-14,6,8901,2558,3624,1205,1,21,16310
2022-03-14,7,8895,3306,4121,1199,2,26,17549
2022-03-14,8,8895,3783,4338,1240,37,44,18337
2022-03-14,9,8898,3728,4332,1221,121,71,18371
2022-03-14,10,8902,3242,4280,970,203,77,17674
2022-03-14,11,8900,2735,4100,1059,283,78,17155
2022-03-14,12,8904,2142,3644,1186,341,78,16295
2022-03-14,13,8905,1992,3670,1095,334,78,16074
2022-03-14,14,8909,1996,3635,1408,280,79,16307
2022-03-14,15,8912,2013,3727,1546,206,80,16484
2022-03-14,16,8899,2118,3860,1190,134,79,16280
2022-03-14,17,8897,2459,4338,1159,72,78,17003
2022-03-14,18,8908,2426,4611,946,27,80,16998
2022-03-14,19,8911,2768,4930,845,0,80,17534
2022-03-14,20,8907,2717,4854,770,0,80,17328
2022-03-14,21,8902,2442,4475,967,0,81,16867
2022-03-14,22,8902,2096,4420,744,0,77,16239
2022-03-14,23,8904,2378,3969,390,0,66,15707
2022-03-14,24,8904,1623,3851,564,0,59,15001
2022-03-15,1,8906,1567,3545,650,0,59,14727
2022-03-15,2,8905,1575,3437,726,0,59,14702
2022-03-15,3,8904,1644,3867,649,0,59,15123
2022-03-15,4,8903,1909,3842,570,0,59,15283
2022-03-15,5,8906,2149,3538,505,0,61,15159
2022-03-15,6,8906,2408,3728,535,2,67,15646
2022-03-15,7,8903,2568,4114,855,4,73,16517
2022-03-15,8,8902,2973,4427,881,43,73,17299
2022-03-15,9,8903,2801,4479,825,110,74,17192
2022-03-15,10,8898,2969,4523,715,180,75,17360
2022-03-15,11,8899,2787,4517,691,207,74,17175
2022-03-15,12,8902,3008,4326,543,184,74,17037
2022-03-15,13,8906,3010,4222,377,138,75,16728
2022-03-15,14,8893,3122,4335,221,156,27,16754
2022-03-15,15,8853,3241,4307,234,122,77,16834
2022-03-15,16,8850,3113,4485,242,66,32,16788
2022-03-15,17,8858,2952,4620,272,58,37,16797
2022-03-15,18,8895,3170,4843,229,20,28,17185
2022-03-15,19,8949,3140,5000,226,2,27,17344
2022-03-15,20,8953,3141,4964,255,1,27,17341
2022-03-15,21,9076,2821,4915,352,0,27,17191
2022-03-15,22,9112,2089,4477,470,0,27,16175
2022-03-15,23,9125,1670,3944,624,0,16,15379
2022-03-15,24,9125,1013,3800,624,0,12,14574
2022-03-16,1,9121,958,3751,517,0,12,14359
2022-03-16,2,9092,1215,3790,509,0,12,14618
2022-03-16,3,9053,1314,3757,512,0,12,14648
2022-03-16,4,9038,1304,3801,385,0,13,14541
2022-03-16,5,8998,1611,3679,360,0,15,14663
2022-03-16,6,8953,2391,4096,332,0,23,15795
2022-03-16,7,8952,3019,4587,282,2,27,16869
2022-03-16,8,8939,3239,4564,299,23,27,17091
2022-03-16,9,8908,2968,4533,358,77,73,16917
2022-03-16,10,8889,2918,4493,359,125,73,16857
2022-03-16,11,8892,2639,4348,404,186,73,16542
2022-03-16,12,8878,2355,4190,464,276,73,16236
2022-03-16,13,8868,2134,4088,480,316,73,15959
2022-03-16,14,8865,2042,4025,436,291,73,15732
2022-03-16,15,8865,2029,4038,510,240,73,15755
2022-03-16,16,8863,2222,4220,476,209,73,16063
2022-03-16,17,8861,2239,4487,584,122,73,16366
2022-03-16,18,8860,2264,4731,899,32,73,16859
2022-03-16,19,8860,2033,4883,1360,3,73,17212
2022-03-16,20,8860,1757,4308,1874,0,72,16871
2022-03-16,21,8860,1734,4055,2218,0,73,16940
2022-03-16,22,8849,1401,3914,2295,0,73,16532
2022-03-16,23,8838,1175,3618,2392,0,63,16086
2022-03-16,24,8838,783,3262,2547,0,60,15490
2022-03-17,1,8849,684,3136,2451,0,13,15133
2022-03-17,2,8847,562,3579,2249,0,13,15250
2022-03-17,3,8852,644,3766,1920,0,12,15194
2022-03-17,4,8849,745,3721,1655,0,13,14983
2022-03-17,5,8854,1046,3312,1675,0,15,14902
2022-03-17,6,8855,1581,3328,1584,0,23,15371
2022-03-17,7,8852,1782,3873,1769,5,27,16308
2022-03-17,8,8851,1962,4122,1822,80,47,16884
2022-03-17,9,8845,1965,3977,1525,205,65,16582
2022-03-17,10,8842,1966,4071,1060,327,79,16345
2022-03-17,11,8838,1963,4155,839,367,78,16240
2022-03-17,12,8841,1680,3860,737,397,78,15593
2022-03-17,13,8848,1963,3589,655,399,78,15532
2022-03-17,14,8848,1847,3704,720,388,78,15585
2022-03-17,15,8847,1461,3733,859,367,78,15345
2022-03-17,16,8862,1460,3717,869,283,78,15269
2022-03-17,17,8868,1594,4464,870,174,78,16048
2022-03-17,18,8865,1602,4407,938,54,78,15944
2022-03-17,19,8861,1555,4726,993,3,77,16215
2022-03-17,20,8861,1592,4541,1201,0,77,16272
2022-03-17,21,8868,1367,4124,1289,0,55,15703
2022-03-17,22,8867,871,4172,1274,0,30,15214
2022-03-17,23,8868,443,4144,1269,0,19,14743
2022-03-17,24,8866,373,3857,1225,0,14,14335
2022-03-18,1,8866,398,4025,962,0,13,14264
2022-03-18,2,8866,408,3704,1067,0,14,14059
2022-03-18,3,8866,391,3576,1385,0,13,14231
2022-03-18,4,8871,477,3375,1429,0,13,14165
2022-03-18,5,8869,787,3381,1184,0,25,14246
2022-03-18,6,8866,1220,3784,962,1,45,14878
2022-03-18,7,8866,1555,4483,821,6,76,15807
2022-03-18,8,8870,1850,4681,705,35,77,16218
2022-03-18,9,8872,2227,4769,535,125,77,16605
2022-03-18,10,8875,1959,4659,462,201,77,16233
2022-03-18,11,8876,1803,4473,489,229,77,15947
2022-03-18,12,8872,1754,4267,461,262,77,15693
2022-03-18,13,8874,1638,3972,582,268,77,15411
2022-03-18,14,8869,1615,3708,598,220,77,15087
2022-03-18,15,8871,1117,4067,810,171,77,15113
2022-03-18,16,8875,821,4295,1175,127,77,15370
2022-03-18,17,8873,794,4356,1603,73,76,15775
2022-03-18,18,8877,789,4185,1863,26,77,15817
2022-03-18,19,8878,792,4028,2473,2,77,16250
2022-03-18,20,8876,464,3958,2715,0,77,16090
2022-03-18,21,8880,367,3719,3075,0,77,16118
2022-03-18,22,8871,366,3782,2935,0,64,16018
2022-03-18,23,8875,387,3586,2871,0,37,15756
2022-03-18,24,8873,366,3365,2573,0,1,15178
2022-03-19,1,8868,367,3339,2525,0,0,15099
2022-03-19,2,8862,366,3551,2572,0,0,15351
2022-03-19,3,8861,367,3443,2369,0,0,15040
2022-03-19,4,8854,367,3435,2721,0,6,15383
2022-03-19,5,8854,366,3550,2533,0,9,15312
2022-03-19,6,8857,381,3953,1998,0,39,15228
2022-03-19,7,8857,416,4610,1717,1,56,15657
2022-03-19,8,8851,496,4610,1665,13,82,15717
2022-03-19,9,8855,447,4427,1939,40,78,15786
2022-03-19,10,8850,409,4324,2122,72,64,15841
2022-03-19,11,8854,482,4593,1988,84,64,16065
2022-03-19,12,8856,527,4447,2076,108,58,16072
2022-03-19,13,8861,529,4240,2254,108,63,16055
2022-03-19,14,8860,399,3912,2436,77,48,15732
2022-03-19,15,8857,400,3936,2464,57,24,15738
2022-03-19,16,8857,433,3981,2559,64,4,15898
2022-03-19,17,8855,403,3859,2728,42,0,15887
2022-03-19,18,8857,369,3587,2990,10,0,15813
2022-03-19,19,8857,369,3630,2898,1,0,15755
2022-03-19,20,8852,368,3953,2619,0,0,15792
2022-03-19,21,8852,382,3850,2645,0,0,15729
2022-03-19,22,8846,368,3312,2627,0,0,15153
2022-03-19,23,8846,366,3241,2569,0,0,15022
2022-03-19,24,8840,367,3187,2700,0,0,15094
2022-03-20,1,8837,368,3209,2785,0,0,15199
2022-03-20,2,8839,369,3256,2617,0,0,15081
2022-03-20,3,8835,369,3480,2598,0,0,15282
2022-03-20,4,8839,368,3459,2698,0,0,15364
2022-03-20,5,8838,367,3298,2728,0,0,15231
2022-03-20,6,8834,369,3643,2718,2,0,15566
2022-03-20,7,8835,383,4059,2605,2,0,15884
2022-03-20,8,8835,380,4768,2365,15,0,16363
2022-03-20,9,8833,478,4594,2199,43,0,16147
2022-03-20,10,8840,432,4212,2003,88,2,15577
2022-03-20,11,8836,402,4188,1696,161,9,15292
2022-03-20,12,8834,406,3608,1663,279,13,14803
2022-03-20,13,8837,539,3562,1674,305,14,14931
2022-03-20,14,8834,615,3347,1529,313,8,14646
2022-03-20,15,8831,813,3397,1522,325,0,14888
2022-03-20,16,8823,1018,3521,1695,319,0,15376
2022-03-20,17,8831,1531,3779,1404,206,0,15751
2022-03-20,18,8832,1384,4243,1026,80,0,15565
2022-03-20,19,8834,1638,4549,927,6,0,15954
2022-03-20,20,8829,1922,4359,995,0,0,16105
2022-03-20,21,8836,1645,4243,812,0,0,15536
2022-03-20,22,8833,1371,4095,632,0,0,14931
2022-03-20,23,8831,616,4081,798,0,0,14326
2022-03-20,24,8832,314,3874,995,0,0,14015
2022-03-21,1,8836,159,3550,1124,0,6,13675
2022-03-21,2,8835,235,3995,969,0,9,14043
2022-03-21,3,8829,647,4047,834,0,9,14366
2022-03-21,4,8832,1323,3821,794,0,9,14779
2022-03-21,5,8829,1704,3567,566,0,14,14680
2022-03-21,6,8833,1891,3997,666,2,31,15420
2022-03-21,7,8831,2343,4454,663,13,46,16350
2022-03-21,8,8831,2417,4485,463,95,69,16360
2022-03-21,9,8828,2016,4136,321,243,54,15598
2022-03-21,10,8826,1985,4021,212,379,53,15476
2022-03-21,11,8826,1975,3880,259,420,76,15436
2022-03-21,12,8827,2045,3667,365,426,76,15406
2022-03-21,13,8826,1685,3579,474,411,77,15052
2022-03-21,14,8830,1818,3293,556,393,77,14967
2022-03-21,15,8827,1856,3390,268,331,77,14749
2022-03-21,16,8824,1938,3557,363,228,77,14987
2022-03-21,17,8823,1692,4139,644,145,77,15520
2022-03-21,18,8816,1659,4999,709,45,77,16305
2022-03-21,19,8818,1767,5253,908,2,77,16825
2022-03-21,20,8818,1629,5159,1207,0,77,16890
2022-03-21,21,8812,1572,4408,1461,0,56,16309
2022-03-21,22,8807,1172,4337,1445,0,54,15815
2022-03-21,23,8807,798,4547,1378,0,19,15549
2022-03-21,24,8801,772,4527,1390,0,11,15501
2022-03-22,1,8801,770,3930,1475,0,11,14987
2022-03-22,2,8797,790,3657,1521,0,11,14776
2022-03-22,3,8799,940,3691,1659,0,11,15100
2022-03-22,4,8825,999,3543,1825,0,11,15203
2022-03-22,5,8615,1389,3295,2014,0,14,15327
2022-03-22,6,8322,1508,3710,2385,1,25,15951
2022-03-22,7,8317,1933,4827,2366,13,27,17483
2022-03-22,8,8320,1721,4830,2151,92,27,17141
2022-03-22,9,8318,1533,4620,2239,221,27,16958
2022-03-22,10,8312,1498,4359,2319,321,27,16836
2022-03-22,11,8328,1496,4345,2477,329,42,17017
2022-03-22,12,8329,1184,4604,2319,320,74,16830
2022-03-22,13,8328,1606,4714,2073,319,77,17117
2022-03-22,14,8331,1441,4490,2083,283,77,16705
2022-03-22,15,8338,1260,4440,2077,260,77,16452
2022-03-22,16,8339,1239,4292,2175,208,77,16330
2022-03-22,17,8345,1127,4569,2398,99,77,16615
2022-03-22,18,8333,1119,5036,2674,31,77,17270
2022-03-22,19,8328,1274,5383,2871,2,76,17934
2022-03-22,20,8335,1618,4827,3231,0,75,18086
2022-03-22,21,8337,1439,4320,3688,0,74,17858
2022-03-22,22,8330,500,3869,3791,0,73,16563
2022-03-22,23,8329,155,3415,3688,0,33,15620
2022-03-22,24,8331,129,3302,3717,0,11,15490
2022-03-23,1,8340,130,3249,3764,0,11,15494
2022-03-23,2,8348,138,3271,3897,0,11,15665
2022-03-23,3,8347,150,3259,4007,0,11,15774
2022-03-23,4,8343,250,3396,4097,0,11,16097
2022-03-23,5,8356,383,3368,3889,0,12,16008
2022-03-23,6,8358,549,3916,3964,0,20,16807
2022-03-23,7,8351,622,4709,4062,6,26,17776
2022-03-23,8,8351,921,5171,3897,21,26,18387
2022-03-23,9,8350,873,5188,3852,50,26,18339
2022-03-23,10,8349,594,4861,3813,86,36,17739
2022-03-23,11,8349,721,4900,3801,136,39,17946
2022-03-23,12,8349,581,4124,3641,172,37,16904
2022-03-23,13,8348,219,4087,3729,125,47,16555
2022-03-23,14,8363,207,3960,4036,108,59,16733
2022-03-23,15,8369,408,3908,4099,81,83,16948
2022-03-23,16,8369,618,4482,4200,46,85,17800
2022-03-23,17,8371,880,4875,4273,26,77,18502
2022-03-23,18,8375,838,5014,4099,9,76,18411
2022-03-23,19,8374,942,5169,3768,1,77,18331
2022-03-23,20,8375,829,4926,3522,0,77,17729
2022-03-23,21,8377,780,4963,3256,0,72,17448
2022-03-23,22,8376,963,4689,2589,0,37,16654
2022-03-23,23,8377,900,4188,2157,0,16,15638
2022-03-23,24,8376,579,3867,2142,0,12,14976
2022-03-24,1,8372,237,3720,2551,0,12,14892
2022-03-24,2,8373,131,3403,3035,0,11,14953
2022-03-24,3,8373,147,3400,3081,0,12,15013
2022-03-24,4,8372,267,3519,3343,0,12,15513
2022-03-24,5,8376,469,3549,3546,0,16,15956
2022-03-24,6,8381,727,3755,3318,1,23,16205
2022-03-24,7,8381,730,4244,3835,3,27,17220
2022-03-24,8,8380,743,4402,3986,15,26,17552
2022-03-24,9,8377,788,4531,3942,56,27,17721
2022-03-24,10,8380,831,4462,3961,134,26,17794
2022-03-24,11,8376,750,4708,3991,237,26,18088
2022-03-24,12,8377,761,4470,3864,229,26,17727
2022-03-24,13,8382,467,4314,3630,209,26,17028
2022-03-24,14,8381,649,4505,3295,177,26,17033
2022-03-24,15,8380,845,4324,3070,193,31,16843
2022-03-24,16,8378,1100,4328,2878,159,38,16881
2022-03-24,17,8381,1111,4459,2722,94,66,16833
2022-03-24,18,8380,1114,4418,2561,29,76,16578
2022-03-24,19,8383,1115,4873,2193,2,76,16642
2022-03-24,20,8379,1199,5182,1880,0,76,16716
2022-03-24,21,8377,1152,4716,1896,0,70,16211
2022-03-24,22,8381,539,4567,1794,0,37,15318
2022-03-24,23,8380,309,4333,1879,0,17,14918
2022-03-24,24,8381,128,4030,1892,0,12,14443
2022-03-25,1,8384,158,3945,2068,0,12,14567
2022-03-25,2,8389,329,3486,2433,0,12,14649
2022-03-25,3,8391,499,3390,2425,0,12,14717
2022-03-25,4,8388,785,3724,2535,0,23,15455
2022-03-25,5,8393,1440,3505,2014,0,33,15385
2022-03-25,6,8394,1512,3748,2141,1,72,15868
2022-03-25,7,8392,1682,4516,2066,10,77,16743
2022-03-25,8,8393,2231,4851,1689,59,77,17300
2022-03-25,9,8392,1854,4915,1603,92,77,16933
2022-03-25,10,8396,1826,4862,1521,109,77,16791
2022-03-25,11,8397,1794,4831,1490,159,77,16748
2022-03-25,12,8394,1920,4759,1402,131,77,16683
2022-03-25,13,8390,2004,4751,1465,100,63,16773
2022-03-25,14,8387,1533,4668,1780,87,27,16482
2022-03-25,15,8385,987,4739,2036,75,27,16249
2022-03-25,16,8387,960,4768,1972,75,27,16189
2022-03-25,17,8390,1274,4937,1960,47,32,16640
2022-03-25,18,8389,1235,5212,1761,17,39,16653
2022-03-25,19,8391,1333,5358,1513,2,67,16664
2022-03-25,20,8389,1339,5254,1490,0,77,16549
2022-03-25,21,8388,1133,4626,1754,0,76,15977
2022-03-25,22,8384,1121,4251,1957,0,77,15790
2022-03-25,23,8380,656,4332,2189,0,67,15624
2022-03-25,24,8373,372,4143,2331,0,14,15233
2022-03-26,1,8368,535,3666,2460,0,0,15029
2022-03-26,2,8369,528,3517,2375,0,0,14789
2022-03-26,3,8375,529,3640,2078,0,0,14622
2022-03-26,4,8381,536,3660,2044,0,0,14621
2022-03-26,5,8377,648,3732,2051,0,16,14824
2022-03-26,6,8382,983,4067,2088,1,22,15543
2022-03-26,7,8382,1200,4362,2172,5,47,16168
2022-03-26,8,8380,1394,4898,2254,29,62,17017
2022-03-26,9,8383,1036,4678,2498,91,51,16737
2022-03-26,10,8377,1299,4884,2634,108,49,17351
2022-03-26,11,8386,1059,4624,2758,145,47,17019
2022-03-26,12,8384,626,4281,3115,168,46,16620
2022-03-26,13,8384,258,3900,3411,125,46,16124
2022-03-26,14,8381,213,3965,3581,118,42,16300
2022-03-26,15,8382,417,3914,3795,96,10,16614
2022-03-26,16,8381,569,4140,4014,88,0,17192
2022-03-26,17,8381,571,4157,3967,50,0,17126
2022-03-26,18,8378,570,4328,4078,18,0,17372
2022-03-26,19,8377,563,4128,4088,1,0,17157
2022-03-26,20,8378,564,4032,3998,1,0,16973
2022-03-26,21,8372,564,4188,3993,0,0,17117
2022-03-26,22,8373,233,4244,4045,0,0,16895
2022-03-26,23,8377,153,3919,4047,0,0,16496
2022-03-26,24,8372,153,3763,3914,0,0,16202
2022-03-27,1,8373,153,3557,3901,0,0,15984
2022-03-27,2,8370,152,3515,3790,0,0,15827
2022-03-27,3,8375,152,3499,3917,0,0,15943
2022-03-27,4,8371,153,3360,3795,0,0,15679
2022-03-27,5,8372,153,3444,3791,0,2,15762
2022-03-27,6,8375,153,3564,3787,0,14,15893
2022-03-27,7,8374,153,3937,3803,2,44,16313
2022-03-27,8,8376,153,4018,4116,18,46,16727
2022-03-27,9,8374,154,4561,4088,53,50,17280
2022-03-27,10,8372,209,4769,3992,92,50,17484
2022-03-27,11,8376,189,4557,3968,160,45,17295
2022-03-27,12,8373,165,4621,4004,216,9,17388
2022-03-27,13,8380,171,4412,4000,225,0,17188
2022-03-27,14,8376,198,4331,4054,227,0,17186
2022-03-27,15,8376,311,4391,3995,193,0,17266
2022-03-27,16,8380,516,4620,4090,179,4,17789
2022-03-27,17,8383,1015,4702,4105,129,7,18341
2022-03-27,18,8380,1041,4977,4013,53,36,18500
2022-03-27,19,8380,1072,5249,3930,6,50,18687
2022-03-27,20,8376,1010,5173,3679,1,50,18289
2022-03-27,21,8372,1528,4963,3512,0,36,18411
2022-03-27,22,8379,1370,4507,3568,0,32,17856
2022-03-27,23,8377,1112,4260,3535,0,3,17287
2022-03-27,24,8378,1066,3868,3397,0,0,16709
2022-03-28,1,8374,1105,3962,3002,0,4,16447
2022-03-28,2,8375,1379,4205,2646,0,12,16617
2022-03-28,3,8378,1696,4182,2433,0,12,16701
2022-03-28,4,8381,1896,4117,2506,0,17,16917
2022-03-28,5,8377,2150,3952,2711,0,29,17219
2022-03-28,6,8373,2656,4663,2843,2,67,18604
2022-03-28,7,8370,3384,4838,3038,8,73,19711
2022-03-28,8,8371,3148,4817,3336,62,73,19807
2022-03-28,9,8375,2422,4855,3502,116,73,19343
2022-03-28,10,8367,2333,4773,3649,170,73,19365
2022-03-28,11,8370,1961,4730,3833,226,73,19193
2022-03-28,12,8370,1877,4547,3731,277,73,18875
2022-03-28,13,8372,1798,4219,3654,308,70,18421
2022-03-28,14,8373,1773,4152,3583,290,34,18205
2022-03-28,15,8374,1884,4340,3371,286,27,18282
2022-03-28,16,8373,2172,4528,3236,226,27,18562
2022-03-28,17,8374,3185,4894,2940,156,29,19578
2022-03-28,18,8370,3301,5378,2529,71,43,19692
2022-03-28,19,8372,3498,5527,2078,7,74,19556
2022-03-28,20,8373,3561,5557,1637,0,74,19202
2022-03-28,21,8379,3582,5534,1225,0,73,18793
2022-03-28,22,8386,3159,4871,1028,0,72,17516
2022-03-28,23,8390,2466,4480,904,0,64,16304
2022-03-28,24,8389,2271,4314,872,0,15,15861
2022-03-29,1,8370,2564,4117,928,0,10,15989
2022-03-29,2,8376,2594,4028,1047,0,9,16054
2022-03-29,3,8379,2572,4067,1177,0,10,16205
2022-03-29,4,8384,2352,4102,1261,0,10,16109
2022-03-29,5,8387,2468,4313,1171,0,13,16352
2022-03-29,6,8385,3696,4832,1080,2,24,18019
2022-03-29,7,8386,3873,5183,939,21,29,18431
2022-03-29,8,8559,3686,5146,582,128,29,18130
2022-03-29,9,8621,3132,4975,433,273,28,17462
2022-03-29,10,8614,2636,4777,355,364,27,16773
2022-03-29,11,8763,2186,4624,251,413,27,16264
2022-03-29,12,8830,1772,4598,216,424,27,15867
2022-03-29,13,8836,1805,4642,221,426,27,15957
2022-03-29,14,8828,1751,4415,275,430,27,15726
2022-03-29,15,8881,1607,4359,372,426,27,15672
2022-03-29,16,8913,1682,4161,451,379,27,15613
2022-03-29,17,8918,1769,4718,481,246,27,16159
2022-03-29,18,8920,1860,5148,487,87,27,16529
2022-03-29,19,8919,2291,5418,492,5,27,17152
2022-03-29,20,8920,2455,5536,604,0,27,17542
2022-03-29,21,8922,2203,5104,875,0,27,17131
2022-03-29,22,8906,1611,4387,1134,0,27,16065
2022-03-29,23,8916,1094,3950,1214,0,19,15193
2022-03-29,24,8920,747,3800,1393,0,10,14870
2022-03-30,1,8915,717,3687,1515,0,10,14844
2022-03-30,2,8913,706,3318,1817,0,10,14764
2022-03-30,3,8916,578,3293,1908,0,11,14706
2022-03-30,4,8913,622,3323,2492,0,12,15362
2022-03-30,5,8914,880,3220,2596,0,28,15638
2022-03-30,6,8913,963,4015,3199,1,40,17131
2022-03-30,7,8916,1074,4706,3285,9,43,18033
2022-03-30,8,8917,1141,5270,3248,42,27,18645
2022-03-30,9,8877,1020,4880,3240,85,27,18129
2022-03-30,10,8876,1161,4882,3348,124,27,18418
2022-03-30,11,8866,1015,4645,3455,156,27,18164
2022-03-30,12,8855,1038,4611,3507,193,32,18236
2022-03-30,13,8853,1012,4306,3472,144,42,17829
2022-03-30,14,8851,1273,4653,3012,103,43,17935
2022-03-30,15,8857,1578,4999,2636,107,44,18221
2022-03-30,16,8854,1638,4861,2633,75,41,18102
2022-03-30,17,8856,1564,4787,2709,52,39,18007
2022-03-30,18,8859,1222,4766,2861,16,34,17758
2022-03-30,19,8862,1123,4543,3075,3,33,17639
2022-03-30,20,8862,1095,4533,3087,0,31,17608
2022-03-30,21,8862,934,4347,3149,0,32,17324
2022-03-30,22,8859,730,4432,2729,0,28,16778
2022-03-30,23,8859,1064,4552,1925,0,21,16421
2022-03-30,24,8863,885,3714,2302,0,14,15778
2022-03-31,1,8861,316,3496,2665,0,12,15350
2022-03-31,2,8863,126,3205,3286,0,12,15492
2022-03-31,3,8861,126,3122,3630,0,12,15751
2022-03-31,4,8862,127,3103,3687,0,12,15791
2022-03-31,5,8863,128,3124,3883,0,15,16013
2022-03-31,6,8861,135,3493,4020,1,20,16530
2022-03-31,7,8862,155,4155,4045,3,27,17247
2022-03-31,8,8864,148,4530,3908,27,20,17497
2022-03-31,9,8870,128,4200,3812,61,26,17097
2022-03-31,10,8869,128,3986,3444,103,27,16557
2022-03-31,11,8868,127,3971,3723,148,27,16864
2022-03-31,12,8869,127,3608,3969,66,27,16666
2022-03-31,13,8869,141,3649,3970,126,27,16782
2022-03-31,14,8864,179,3507,3995,178,27,16750
2022-03-31,15,8860,238,3626,4018,170,27,16939
2022-03-31,16,8855,537,3823,4040,155,27,17437
2022-03-31,17,8858,508,4243,3839,126,27,17601
2022-03-31,18,8858,501,4320,3780,44,27,17530
2022-03-31,19,8859,501,4423,3638,3,27,17451
2022-03-31,20,8858,502,4657,3253,0,27,17297
2022-03-31,21,8853,516,4947,2669,0,27,17012
2022-03-31,22,8853,229,4413,2453,0,27,15975
2022-03-31,23,8855,127,4094,2248,0,16,15340
2022-03-31,24,8859,127,3984,2005,0,4,14979
2022-04-01,1,8861,128,3800,1802,0,0,14591
2022-04-01,2,8861,167,3629,1767,0,0,14424
2022-04-01,3,8860,174,3626,1730,0,0,14390
2022-04-01,4,8855,410,3624,1868,0,0,14757
2022-04-01,5,8857,852,3215,1881,0,1,14806
2022-04-01,6,8858,916,3602,1878,2,6,15262
2022-04-01,7,8857,1074,4361,1986,12,26,16316
2022-04-01,8,8859,1350,4760,1992,43,26,17030
2022-04-01,9,8859,1103,4703,2381,71,32,17149
2022-04-01,10,8861,742,4441,2619,106,34,16803
2022-04-01,11,8865,736,4165,2647,155,34,16602
2022-04-01,12,8864,428,4054,2920,211,33,16510
2022-04-01,13,8858,402,3895,3061,187,31,16434
2022-04-01,14,8853,418,4035,3336,200,22,16864
2022-04-01,15,8965,436,4094,3451,169,18,17133
2022-04-01,16,9064,495,4214,3426,127,13,17339
2022-04-01,17,9080,720,4468,3130,68,0,17466
2022-04-01,18,9082,715,4922,2746,25,0,17490
2022-04-01,19,9086,636,5250,2166,4,0,17142
2022-04-01,20,9100,703,5421,1738,0,0,16962
2022-04-01,21,9100,531,5178,1425,0,0,16234
2022-04-01,22,9111,540,4778,1224,0,0,15653
2022-04-01,23,9127,534,4265,1012,0,0,14938
2022-04-01,24,9132,332,4043,803,0,0,14310
2022-04-02,1,9134,234,4025,661,0,0,14054
2022-04-02,2,9128,250,3879,590,0,0,13847
2022-04-02,3,9131,203,3770,458,0,0,13562
2022-04-02,4,9137,368,4071,331,0,0,13907
2022-04-02,5,9145,809,3831,242,1,0,14028
2022-04-02,6,9150,849,4290,246,2,0,14537
2022-04-02,7,9172,851,4446,220,28,0,14717
2022-04-02,8,9172,733,4576,189,137,2,14809
2022-04-02,9,9173,562,4748,208,280,6,14977
2022-04-02,10,9169,561,4832,266,370,28,15226
2022-04-02,11,9170,622,4608,362,406,50,15218
2022-04-02,12,9167,590,4311,455,413,50,14986
2022-04-02,13,9173,573,4200,461,399,50,14856
2022-04-02,14,9180,608,4190,358,372,62,14770
2022-04-02,15,9180,883,4300,249,325,65,15002
2022-04-02,16,9189,874,4233,216,225,50,14787
2022-04-02,17,9186,1107,4646,122,133,50,15244
2022-04-02,18,9191,1360,4766,135,47,50,15549
2022-04-02,19,9192,1165,4845,152,9,50,15413
2022-04-02,20,9192,1369,4961,204,0,50,15776
2022-04-02,21,9194,1148,4671,309,0,50,15372
2022-04-02,22,9193,919,4225,273,0,50,14660
2022-04-02,23,9191,681,4070,149,0,45,14136
2022-04-02,24,9194,636,3876,156,0,20,13882
2022-04-03,1,9193,335,3570,196,0,0,13294
2022-04-03,2,9191,158,3471,251,0,0,13071
2022-04-03,3,9186,148,3657,264,0,0,13255
2022-04-03,4,9187,293,3707,384,0,0,13571
2022-04-03,5,9183,520,3607,497,0,0,13807
2022-04-03,6,9182,532,3478,742,1,0,13935
2022-04-03,7,9185,543,3815,1006,11,0,14560
2022-04-03,8,9183,568,4263,1049,37,0,15100
2022-04-03,9,9181,920,4503,944,84,0,15632
2022-04-03,10,9179,1078,4416,925,109,0,15707
2022-04-03,11,9179,983,4338,1016,146,0,15662
2022-04-03,12,9185,1039,4067,1058,193,5,15547
2022-04-03,13,8910,1075,3995,1124,137,17,15258
2022-04-03,14,8662,1383,4108,1175,134,48,15510
2022-04-03,15,8663,1413,4055,1165,136,50,15482
2022-04-03,16,8666,1751,4401,1062,87,50,16017
2022-04-03,17,8663,1955,4775,943,69,65,16470
2022-04-03,18,8664,1941,4969,774,39,77,16464
2022-04-03,19,8661,2031,5177,540,7,88,16504
2022-04-03,20,8660,2024,5198,354,0,98,16334
2022-04-03,21,8665,1847,5082,327,0,53,15974
2022-04-03,22,8660,1715,4698,338,0,5,15416
2022-04-03,23,8666,1698,4129,276,0,0,14769
2022-04-03,24,8664,1523,3712,254,0,0,14153
2022-04-04,1,8662,1487,3608,235,0,0,13992
2022-04-04,2,8660,1501,3550,227,0,0,13938
2022-04-04,3,8662,1400,3611,268,0,0,13941
2022-04-04,4,8661,1455,3614,311,0,0,14041
2022-04-04,5,8665,1497,3759,278,0,4,14203
2022-04-04,6,8659,2169,4859,329,3,31,16050
2022-04-04,7,8660,2246,5017,467,30,60,16480
2022-04-04,8,8657,2004,4946,470,113,64,16254
2022-04-04,9,8655,1930,5053,298,221,55,16212
2022-04-04,10,8655,2287,5026,285,314,50,16617
2022-04-04,11,8662,2325,4669,438,265,34,16393
2022-04-04,12,8669,1879,4716,617,271,0,16152
2022-04-04,13,8671,1991,4378,902,207,0,16149
2022-04-04,14,8672,1620,4327,1236,218,0,16073
2022-04-04,15,8676,1494,3997,1638,190,0,15995
2022-04-04,16,8673,1581,4216,1519,133,6,16128
2022-04-04,17,8675,1814,4781,1228,107,38,16643
2022-04-04,18,8674,2219,4916,955,49,49,16862
2022-04-04,19,8673,2380,5141,922,6,49,17171
2022-04-04,20,8673,2290,5093,999,1,47,17103
2022-04-04,21,8669,1940,4798,1082,0,43,16532
2022-04-04,22,8668,1426,4398,1218,0,10,15720
2022-04-04,23,8669,1160,3739,1265,0,0,14833
2022-04-04,24,8667,1079,3358,1352,0,0,14456
2022-04-05,1,8664,1071,3415,1392,0,0,14542
2022-04-05,2,8662,1157,3298,1406,0,0,14523
2022-04-05,3,8671,1126,3320,1206,0,0,14323
2022-04-05,4,8670,1221,3537,1090,0,1,14519
2022-04-05,5,8676,1269,3576,1132,0,25,14678
2022-04-05,6,8674,1943,4025,1029,1,46,15718
2022-04-05,7,8596,2299,4563,896,9,46,16409
2022-04-05,8,8589,2333,4786,586,47,46,16387
2022-04-05,9,8583,2266,4990,370,168,46,16423
2022-04-05,10,8591,2131,4918,203,276,37,16156
2022-04-05,11,8557,2014,4658,214,314,12,15769
2022-04-05,12,8487,2131,4366,248,321,0,15553
2022-04-05,13,8490,1650,4258,280,381,0,15059
2022-04-05,14,8490,1635,4296,302,372,0,15095
2022-04-05,15,8490,1405,4209,357,294,0,14755
2022-04-05,16,8497,1464,4706,339,217,0,15223
2022-04-05,17,8497,1568,4854,339,165,0,15423
2022-04-05,18,8499,1418,4933,437,75,0,15362
2022-04-05,19,8499,1450,5025,690,11,0,15675
2022-04-05,20,8491,1479,4814,1219,1,0,16004
2022-04-05,21,8494,1420,4526,1821,0,0,16261
2022-04-05,22,8488,646,4064,2277,0,0,15475
2022-04-05,23,8492,280,3327,2583,0,0,14682
2022-04-05,24,8486,128,3323,2706,0,0,14643
2022-04-06,1,8485,131,3040,2993,0,3,14652
2022-04-06,2,8488,168,3105,2626,0,13,14400
2022-04-06,3,8491,207,3050,2581,0,46,14375
2022-04-06,4,8488,322,3209,2554,0,48,14621
2022-04-06,5,8487,631,3337,2313,1,49,14818
2022-04-06,6,8490,739,3768,2309,2,50,15358
2022-04-06,7,8491,859,4070,2419,23,43,15905
2022-04-06,8,8490,968,4444,2357,117,1,16377
2022-04-06,9,8491,972,4513,2140,231,0,16347
2022-04-06,10,8489,1091,4616,2252,285,0,16733
2022-04-06,11,8487,417,4232,2730,304,0,16170
2022-04-06,12,8482,129,4059,2834,299,0,15803
2022-04-06,13,8482,132,3972,2835,321,0,15742
2022-04-06,14,8481,242,4453,2805,221,0,16202
2022-04-06,15,8482,383,4187,2963,170,0,16185
2022-04-06,16,8480,694,4697,2972,91,0,16934
2022-04-06,17,8478,884,4881,2733,70,0,17046
2022-04-06,18,8481,916,4889,2907,21,0,17214
2022-04-06,19,8486,826,4917,2760,2,0,16991
2022-04-06,20,8486,844,4982,2386,0,0,16698
2022-04-06,21,8490,1030,4949,1544,0,0,16013
2022-04-06,22,8487,1098,4679,1088,0,0,15352
2022-04-06,23,8476,810,3979,1113,0,0,14378
2022-04-06,24,8476,547,3785,1356,0,0,14164
2022-04-07,1,8478,215,3478,1742,0,0,13913
2022-04-07,2,8478,206,3368,2085,0,0,14137
2022-04-07,3,8477,541,3210,2083,0,0,14311
2022-04-07,4,8480,662,3198,2021,0,0,14361
2022-04-07,5,8474,893,3331,1763,0,0,14461
2022-04-07,6,8477,878,3646,2037,1,0,15039
2022-04-07,7,8475,902,4403,1965,9,0,15754
2022-04-07,8,8475,1062,4998,1801,61,0,16397
2022-04-07,9,8473,1045,4917,1703,116,0,16254
2022-04-07,10,8471,652,4779,2052,183,0,16137
2022-04-07,11,8470,248,4566,2298,202,0,15784
2022-04-07,12,8472,166,4324,2316,250,0,15528
2022-04-07,13,8475,202,4116,2502,201,0,15496
2022-04-07,14,8473,461,4019,2375,226,7,15561
2022-04-07,15,8461,939,4582,1997,161,20,16160
2022-04-07,16,8462,1319,4515,1746,85,42,16169
2022-04-07,17,8476,1563,5175,1411,52,50,16727
2022-04-07,18,8479,1547,5203,977,40,50,16296
2022-04-07,19,8479,1237,5500,682,5,50,15953
2022-04-07,20,8482,1462,5363,655,0,50,16012
2022-04-07,21,8483,1385,4961,735,0,50,15614
2022-04-07,22,8486,1258,4792,747,0,48,15331
2022-04-07,23,8458,1073,4285,735,0,9,14560
2022-04-07,24,8451,930,3844,704,0,0,13929
2022-04-08,1,8452,892,3561,804,0,0,13709
2022-04-08,2,8454,887,3522,949,0,0,13812
2022-04-08,3,8451,955,3414,1079,0,0,13899
2022-04-08,4,8450,1017,3545,1010,0,0,14022
2022-04-08,5,8435,1207,3518,809,0,0,13969
2022-04-08,6,8435,1466,3994,840,2,0,14737
2022-04-08,7,8433,1813,4707,900,7,0,15860
2022-04-08,8,8429,2003,5001,743,49,0,16225
2022-04-08,9,8428,2188,5015,773,153,0,16557
2022-04-08,10,8424,2107,4853,1083,223,0,16690
2022-04-08,11,8403,1804,4625,1428,218,2,16480
2022-04-08,12,8405,1358,4168,1638,207,22,15798
2022-04-08,13,8389,1135,3935,1827,287,46,15619
2022-04-08,14,8300,981,3561,1697,351,45,14935
2022-04-08,15,8295,795,3790,1747,318,45,14990
2022-04-08,16,8318,791,3942,1733,260,45,15089
2022-04-08,17,8514,784,4627,1540,186,45,15696
2022-04-08,18,8623,803,5182,1279,65,57,16009
2022-04-08,19,8659,784,5457,1036,11,64,16011
2022-04-08,20,8661,786,5634,881,0,70,16032
2022-04-08,21,8663,841,5461,882,0,69,15916
2022-04-08,22,8666,783,5084,698,0,48,15279
2022-04-08,23,8662,788,4475,677,0,21,14623
2022-04-08,24,8655,580,3963,692,0,0,13890
2022-04-09,1,8654,343,3852,717,0,0,13566
2022-04-09,2,8661,329,3806,661,0,0,13457
2022-04-09,3,8660,533,4041,606,0,0,13840
2022-04-09,4,8663,632,3893,537,0,0,13725
2022-04-09,5,8665,772,3661,421,1,0,13520
2022-04-09,6,8667,816,3861,510,2,0,13856
2022-04-09,7,8667,1037,4102,544,28,0,14378
2022-04-09,8,8665,1114,4691,553,93,0,15116
2022-04-09,9,8665,1121,4591,586,168,0,15131
2022-04-09,10,8665,1163,4765,738,202,0,15533
2022-04-09,11,8664,1158,4560,897,194,0,15473
2022-04-09,12,8667,1227,4409,1034,192,0,15529
2022-04-09,13,8666,1131,4351,1294,159,0,15601
2022-04-09,14,8669,1073,4556,1344,164,0,15806
2022-04-09,15,8665,838,4676,1334,138,0,15651
2022-04-09,16,8667,1165,4489,1361,104,0,15786
2022-04-09,17,8666,1221,4744,1295,64,0,15990
2022-04-09,18,8663,1238,4990,1122,27,0,16040
2022-04-09,19,8660,1282,5175,1032,4,0,16153
2022-04-09,20,8655,995,5091,1047,0,0,15788
2022-04-09,21,8659,1036,5054,825,0,0,15574
2022-04-09,22,8661,718,4692,846,0,0,14917
2022-04-09,23,8663,581,3951,1051,0,0,14246
2022-04-09,24,8658,206,3764,1190,0,0,13818
2022-04-10,1,8658,140,3470,1384,0,0,13652
2022-04-10,2,8653,137,3440,1611,0,0,13841
2022-04-10,3,8650,136,3430,1801,0,0,14017
2022-04-10,4,8653,135,3584,1723,0,0,14095
2022-04-10,5,8659,151,3419,1963,1,0,14193
2022-04-10,6,8660,192,3446,1757,2,0,14057
2022-04-10,7,8659,333,3552,1863,18,0,14425
2022-04-10,8,8656,337,3990,1935,83,0,15001
2022-04-10,9,8655,330,4261,1671,171,0,15088
2022-04-10,10,8654,344,4235,1665,253,0,15151
2022-04-10,11,8653,348,4144,1435,208,0,14788
2022-04-10,12,8658,402,4213,1196,217,0,14686
2022-04-10,13,8658,535,4333,929,238,0,14693
2022-04-10,14,8662,809,3993,838,274,0,14576
2022-04-10,15,8623,888,4017,672,279,0,14479
2022-04-10,16,8658,950,4167,728,237,0,14740
2022-04-10,17,8661,1089,4573,696,185,0,15204
2022-04-10,18,8662,925,4681,688,86,0,15042
2022-04-10,19,8665,895,4960,763,13,0,15296
2022-04-10,20,8665,886,4574,808,0,0,14933
2022-04-10,21,8668,786,4502,829,0,0,14785
2022-04-10,22,8667,686,4149,920,0,0,14422
2022-04-10,23,8666,365,3823,924,0,0,13778
2022-04-10,24,8663,155,3475,1388,0,0,13681
2022-04-11,1,8663,128,3374,1864,0,0,14029
2022-04-11,2,8664,128,3308,2126,0,0,14226
2022-04-11,3,8659,129,3268,2672,0,0,14728
2022-04-11,4,8660,194,3289,2690,0,0,14833
2022-04-11,5,8663,428,3290,2797,0,0,15178
2022-04-11,6,8669,710,3380,3098,2,0,15859
2022-04-11,7,8666,705,3810,3602,36,0,16819
2022-04-11,8,8666,692,4354,3281,119,0,17112
2022-04-11,9,8665,555,4716,3014,167,0,17117
2022-04-11,10,8664,551,4223,2279,222,0,15939
2022-04-11,11,8667,546,4046,2517,345,0,16121
2022-04-11,12,8665,276,3945,2494,370,0,15750
2022-04-11,13,8658,460,3695,2311,375,0,15499
2022-04-11,14,8654,556,3751,2683,232,0,15876
2022-04-11,15,8657,671,4016,2619,168,0,16131
2022-04-11,16,8659,944,4020,2808,102,1,16534
2022-04-11,17,8659,938,4350,2770,74,11,16802
2022-04-11,18,8655,930,4885,2497,23,45,17035
2022-04-11,19,8653,866,5288,2080,2,54,16943
2022-04-11,20,8654,738,5206,1739,0,54,16391
2022-04-11,21,8655,736,4593,1811,0,54,15849
2022-04-11,22,8663,243,4305,1744,0,50,15005
2022-04-11,23,8663,128,4322,1562,0,11,14686
2022-04-11,24,8659,128,4469,1311,0,0,14567
2022-04-12,1,8659,159,4410,1018,0,0,14246
2022-04-12,2,8660,182,4048,880,0,0,13770
2022-04-12,3,8662,320,4124,679,0,0,13785
2022-04-12,4,8661,638,4386,558,0,0,14243
2022-04-12,5,8662,1145,3887,468,1,8,14171
2022-04-12,6,8664,1139,4370,349,2,42,14566
2022-04-12,7,8662,1257,4993,183,30,48,15173
2022-04-12,8,8663,1294,5274,207,154,55,15647
2022-04-12,9,8659,1279,5240,212,295,55,15740
2022-04-12,10,8662,1140,4698,423,381,55,15359
2022-04-12,11,8662,464,4904,418,399,55,14902
2022-04-12,12,8660,358,4750,461,411,55,14695
2022-04-12,13,8660,388,4414,548,408,55,14473
2022-04-12,14,8653,550,4247,704,409,55,14618
2022-04-12,15,8655,548,4202,783,395,55,14638
2022-04-12,16,8657,626,4637,738,329,55,15042
2022-04-12,17,8656,821,4948,713,206,55,15399
2022-04-12,18,8652,942,5566,747,89,55,16051
2022-04-12,19,8652,937,5438,928,14,55,16024
2022-04-12,20,8656,932,5190,1375,0,55,16208
2022-04-12,21,8650,426,4641,1797,0,55,15569
2022-04-12,22,8649,312,4278,1995,0,53,15287
2022-04-12,23,8648,313,3807,2120,0,7,14895
2022-04-12,24,8654,311,3542,2207,0,0,14714
2022-04-13,1,8659,135,3346,1953,0,0,14093
2022-04-13,2,8662,126,3116,1949,0,0,13853
2022-04-13,3,8674,129,3208,1772,0,0,13783
2022-04-13,4,8692,129,3164,1944,0,0,13929
2022-04-13,5,8733,126,3107,2699,1,0,14666
2022-04-13,6,8741,127,3661,3028,2,0,15559
2022-04-13,7,8749,128,4476,3271,17,0,16641
2022-04-13,8,8748,127,4773,3392,44,0,17084
2022-04-13,9,8750,127,4743,3427,85,0,17132
2022-04-13,10,8787,127,4490,3535,130,16,17085
2022-04-13,11,8863,127,4424,3500,122,48,17084
2022-04-13,12,8911,127,4373,3560,174,55,17200
2022-04-13,13,8908,128,4421,3617,156,56,17286
2022-04-13,14,8917,128,4536,3511,123,56,17271
2022-04-13,15,8920,129,4412,3463,177,40,17141
2022-04-13,16,8921,128,4783,3533,120,0,17485
2022-04-13,17,8922,129,4909,3397,86,0,17443
2022-04-13,18,8915,129,4835,3530,32,0,17441
2022-04-13,19,8912,129,5070,3407,8,0,17526
2022-04-13,20,8917,129,5128,3335,0,0,17509
2022-04-13,21,8915,129,4737,3400,0,0,17181
2022-04-13,22,9002,130,4226,3206,0,0,16564
2022-04-13,23,9070,132,3589,2588,0,0,15379
2022-04-13,24,9097,149,3363,2004,0,0,14613
2022-04-14,1,9098,157,3223,1673,0,0,14151
2022-04-14,2,9090,157,3196,1225,0,1,13669
2022-04-14,3,9086,157,3158,1072,0,0,13473
2022-04-14,4,9084,158,3205,1248,0,1,13696
2022-04-14,5,8989,156,3210,1714,0,20,14089
2022-04-14,6,8992,157,3261,2653,2,50,15115
2022-04-14,7,8988,159,3807,3140,5,51,16150
2022-04-14,8,8984,158,4576,3395,30,51,17194
2022-04-14,9,8985,158,4608,3406,110,51,17318
2022-04-14,10,9028,159,4290,3091,176,50,16794
2022-04-14,11,9096,157,4248,2816,248,16,16581
2022-04-14,12,9129,157,4188,2467,263,0,16204
2022-04-14,13,9137,158,4132,2019,297,0,15743
2022-04-14,14,9138,159,4078,2058,285,0,15718
2022-04-14,15,9133,160,3997,2256,279,0,15825
2022-04-14,16,9131,158,3955,2768,263,0,16275
2022-04-14,17,9137,141,4235,2877,206,0,16596
2022-04-14,18,9143,127,4807,2658,87,11,16833
2022-04-14,19,9142,127,4764,3072,13,42,17160
2022-04-14,20,9141,127,4677,3784,0,48,17777
2022-04-14,21,9142,128,4629,3391,0,49,17339
2022-04-14,22,9144,127,4446,2817,0,49,16583
2022-04-14,23,9145,127,3833,2354,0,49,15508
2022-04-14,24,9141,127,3541,1744,0,49,14602
2022-04-15,1,9137,127,3504,1283,0,7,14058
2022-04-15,2,9139,126,3429,1067,0,1,13762
2022-04-15,3,9141,126,3334,1278,0,2,13881
2022-04-15,4,9140,127,3417,1119,0,0,13803
2022-04-15,5,9133,128,3353,1447,1,3,14065
2022-04-15,6,9133,129,3377,1849,3,18,14509
2022-04-15,7,9129,128,3504,1800,40,48,14649
2022-04-15,8,9129,127,3490,2194,135,51,15126
2022-04-15,9,9132,132,3584,2031,202,51,15132
2022-04-15,10,9127,124,3778,1916,239,49,15233
2022-04-15,11,9120,124,3822,2084,231,47,15428
2022-04-15,12,9121,123,3891,2132,218,47,15532
2022-04-15,13,9124,123,3920,2297,243,47,15754
2022-04-15,14,9115,123,3848,2421,237,7,15751
2022-04-15,15,9101,123,3959,2440,178,2,15803
2022-04-15,16,9102,123,4018,3103,98,1,16445
2022-04-15,17,9100,124,3944,3467,44,0,16679
2022-04-15,18,9094,124,4136,3316,25,7,16702
2022-04-15,19,9091,122,3968,3436,7,37,16661
2022-04-15,20,9091,123,3995,3452,1,56,16718
2022-04-15,21,9105,123,4156,3125,0,56,16565
2022-04-15,22,9114,123,4469,2307,0,56,16069
2022-04-15,23,9115,123,4066,1880,0,57,15241
2022-04-15,24,9120,123,3753,1541,0,56,14593
2022-04-16,1,9124,123,3746,1347,0,11,14351
2022-04-16,2,9124,123,3890,1011,0,0,14148
2022-04-16,3,9125,123,4315,571,0,0,14134
2022-04-16,4,9123,123,4336,605,0,0,14187
2022-04-16,5,9124,123,4563,587,0,0,14397
2022-04-16,6,9127,123,4903,595,2,0,14750
2022-04-16,7,9127,127,5639,508,22,0,15423
2022-04-16,8,9125,145,5760,494,99,1,15624
2022-04-16,9,9131,123,4877,627,230,0,14988
2022-04-16,10,9141,123,4978,944,331,0,15517
2022-04-16,11,9142,123,4883,1137,292,0,15577
2022-04-16,12,9141,123,4708,1370,268,0,15610
2022-04-16,13,9144,123,4639,1472,294,0,15672
2022-04-16,14,9148,123,4648,1532,312,2,15765
2022-04-16,15,9147,123,4658,1858,227,0,16013
2022-04-16,16,9143,123,4746,2159,170,0,16341
2022-04-16,17,9142,123,5504,1852,117,1,16739
2022-04-16,18,9141,123,5803,1577,46,0,16690
2022-04-16,19,9159,123,5374,1597,11,0,16264
2022-04-16,20,9152,124,5514,1652,0,0,16442
2022-04-16,21,9156,124,5651,1637,0,3,16571
2022-04-16,22,9154,124,5379,1720,0,9,16386
2022-04-16,23,9107,124,4679,1927,0,33,15870
2022-04-16,24,9095,123,3875,1878,0,56,15027
2022-04-17,1,9097,123,3832,1631,0,56,14739
2022-04-17,2,9094,123,3695,1685,0,56,14653
2022-04-17,3,9088,124,3776,1528,0,56,14572
2022-04-17,4,9100,123,3788,1626,0,48,14685
2022-04-17,5,9107,123,3934,1693,0,30,14887
2022-04-17,6,9109,123,4475,1551,2,0,15260
2022-04-17,7,9110,123,4666,1451,24,0,15374
2022-04-17,8,9107,123,5416,1227,102,0,15975
2022-04-17,9,9106,123,5461,1020,223,0,15933
2022-04-17,10,9112,124,5702,665,308,0,15911
2022-04-17,11,9114,182,5813,464,299,0,15872
2022-04-17,12,9115,143,5560,396,290,16,15520
2022-04-17,13,9117,150,4858,537,300,51,15013
2022-04-17,14,9110,161,4663,654,314,54,14956
2022-04-17,15,9108,188,4528,721,311,55,14911
2022-04-17,16,9118,314,4709,681,339,54,15215
2022-04-17,17,9110,314,4985,562,246,41,15258
2022-04-17,18,9110,314,5229,483,106,0,15242
2022-04-17,19,9111,314,5412,384,16,0,15237
2022-04-17,20,9108,314,5411,294,0,0,15127
2022-04-17,21,9116,314,5273,392,0,0,15095
2022-04-17,22,9110,162,5329,473,0,0,15074
2022-04-17,23,9110,124,5211,618,0,0,15063
2022-04-17,24,9101,124,5041,784,0,0,15050
2022-04-18,1,9106,124,4601,1073,0,0,14904
2022-04-18,2,9107,123,4310,1354,0,3,14897
2022-04-18,3,9098,123,4465,1732,0,9,15427
2022-04-18,4,9102,124,4294,1834,0,40,15394
2022-04-18,5,9095,124,4153,1757,2,54,15185
2022-04-18,6,9099,123,4222,2212,3,54,15713
2022-04-18,7,9098,124,4303,2322,52,52,15951
2022-04-18,8,9100,126,4348,2108,171,83,15936
2022-04-18,9,9102,129,4643,2179,276,78,16407
2022-04-18,10,9079,179,4461,2382,318,55,16474
2022-04-18,11,9087,200,4814,2561,292,58,17012
2022-04-18,12,9083,254,5228,2362,275,72,17274
2022-04-18,13,9081,504,5508,2005,251,99,17448
2022-04-18,14,9081,764,5092,1769,166,71,16943
2022-04-18,15,9088,844,4876,1246,110,0,16164
2022-04-18,16,9085,1011,5688,1110,67,0,16961
2022-04-18,17,9085,1479,5645,810,24,0,17043
2022-04-18,18,9092,1297,5447,840,11,0,16687
2022-04-18,19,9094,1137,4831,1063,3,0,16128
2022-04-18,20,9090,912,4850,1190,1,0,16043
2022-04-18,21,9087,923,4633,1414,0,0,16057
2022-04-18,22,9079,327,4927,1473,0,0,15806
2022-04-18,23,9040,124,4838,1467,0,0,15469
2022-04-18,24,8985,124,4791,1487,0,0,15387
2022-04-19,1,9095,124,4232,1566,0,12,15029
2022-04-19,2,9136,124,4228,1516,0,49,15053
2022-04-19,3,9139,124,4507,1555,0,53,15378
2022-04-19,4,9150,125,3987,1821,0,51,15134
2022-04-19,5,9148,125,3751,2081,0,53,15158
2022-04-19,6,9148,126,3947,2388,1,53,15663
2022-04-19,7,9141,125,5017,2516,5,54,16858
2022-04-19,8,9139,125,5195,2710,17,54,17240
2022-04-19,9,9138,125,5060,2909,65,54,17351
2022-04-19,10,9136,127,4978,3091,98,54,17484
2022-04-19,11,9121,130,5003,3326,108,54,17742
2022-04-19,12,9131,137,4951,3544,140,11,17914
2022-04-19,13,9131,144,4570,3684,147,0,17676
2022-04-19,14,9133,147,4391,3794,153,0,17618
2022-04-19,15,9136,150,4356,3841,140,0,17623
2022-04-19,16,9127,174,4672,3938,100,0,18011
2022-04-19,17,9112,298,4805,4014,68,1,18298
2022-04-19,18,9108,323,5064,3918,36,5,18454
2022-04-19,19,9104,321,5290,3737,8,0,18460
2022-04-19,20,9109,323,5257,3527,1,0,18217
2022-04-19,21,9102,323,5109,3454,0,0,17988
2022-04-19,22,9099,322,4876,3387,0,0,17684
2022-04-19,23,9099,243,4434,3151,0,0,16927
2022-04-19,24,9100,124,4381,2827,0,0,16432
2022-04-20,1,9100,126,4529,2220,0,0,15975
2022-04-20,2,9104,243,4717,1794,0,0,15858
2022-04-20,3,9099,301,4836,1509,0,0,15745
2022-04-20,4,9103,471,4464,1333,0,21,15392
2022-04-20,5,9106,649,4378,935,1,44,15113
2022-04-20,6,9110,930,4471,635,3,50,15199
2022-04-20,7,9111,927,4833,415,46,55,15387
2022-04-20,8,9106,921,4973,348,156,59,15563
2022-04-20,9,9102,942,4774,333,278,38,15467
2022-04-20,10,9096,930,5064,275,370,1,15736
2022-04-20,11,9102,608,4916,357,394,10,15387
2022-04-20,12,9107,185,4662,535,415,0,14904
2022-04-20,13,9096,121,4630,700,427,0,14974
2022-04-20,14,9101,128,4423,793,419,1,14865
2022-04-20,15,9098,260,4549,787,397,2,15093
2022-04-20,16,9095,483,4699,922,325,0,15524
2022-04-20,17,9096,741,4986,1158,215,0,16196
2022-04-20,18,9102,740,4735,1576,89,0,16242
2022-04-20,19,9101,741,4567,1936,17,0,16362
2022-04-20,20,9098,743,5000,2258,0,0,17099
2022-04-20,21,9084,753,4829,2716,0,0,17382
2022-04-20,22,9078,740,4230,3097,0,0,17145
2022-04-20,23,9073,265,3911,3183,0,0,16432
2022-04-20,24,9071,121,3713,3109,0,1,16015
2022-04-21,1,9074,122,3772,2650,0,0,15618
2022-04-21,2,9074,122,3430,2735,0,0,15361
2022-04-21,3,9073,122,3306,2757,0,8,15266
2022-04-21,4,9073,122,3328,2717,0,35,15275
2022-04-21,5,9071,123,3325,3136,1,55,15711
2022-04-21,6,9069,123,3670,3508,4,49,16423
2022-04-21,7,9065,122,4542,3933,21,49,17732
2022-04-21,8,9065,123,4792,3997,52,49,18078
2022-04-21,9,9064,123,4505,3975,73,49,17789
2022-04-21,10,9059,122,4725,3997,67,49,18019
2022-04-21,11,9066,122,4843,3949,65,49,18094
2022-04-21,12,9067,122,4610,3767,83,49,17698
2022-04-21,13,9055,122,4625,3657,101,49,17609
2022-04-21,14,9062,121,4469,3457,155,50,17314
2022-04-21,15,9055,123,4485,3224,225,14,17126
2022-04-21,16,9058,126,4795,3210,209,0,17398
2022-04-21,17,9058,125,4783,3303,161,0,17430
2022-04-21,18,9060,125,4524,3303,90,0,17102
2022-04-21,19,9054,125,4858,3051,15,13,17116
2022-04-21,20,9057,125,5253,2959,1,43,17438
2022-04-21,21,9050,124,5056,2719,1,51,17001
2022-04-21,22,9044,125,5023,2475,0,53,16720
2022-04-21,23,9040,125,4508,2332,0,52,16057
2022-04-21,24,9040,125,4195,2250,0,51,15661
2022-04-22,1,9043,125,4080,2060,0,51,15359
2022-04-22,2,9034,131,3969,2010,0,51,15195
2022-04-22,3,9039,204,4080,1783,0,52,15158
2022-04-22,4,9037,278,4446,1591,0,51,15403
2022-04-22,5,9039,412,4425,1420,2,51,15349
2022-04-22,6,9042,548,4570,1283,4,48,15495
2022-04-22,7,9041,548,5244,932,44,48,15857
2022-04-22,8,9043,567,5470,507,167,41,15795
2022-04-22,9,9033,542,5236,425,299,0,15535
2022-04-22,10,9029,551,5049,293,343,0,15265
2022-04-22,11,9040,551,5251,213,370,0,15425
2022-04-22,12,9026,226,5081,197,408,0,14938
2022-04-22,13,9014,178,4905,259,401,13,14770
2022-04-22,14,9020,377,4495,324,389,48,14653
2022-04-22,15,9015,545,4463,376,336,56,14791
2022-04-22,16,9017,542,5052,406,267,56,15340
2022-04-22,17,9017,545,5335,457,179,57,15590
2022-04-22,18,9017,539,5077,453,75,56,15217
2022-04-22,19,9015,537,5029,483,14,5,15083
2022-04-22,20,9015,537,5042,631,0,0,15225
2022-04-22,21,9008,534,4811,970,0,0,15323
2022-04-22,22,9007,205,4495,1267,0,0,14974
2022-04-22,23,9005,121,4156,1536,0,0,14818
2022-04-22,24,8999,122,3889,1771,0,0,14781
2022-04-23,1,9004,122,3860,1967,0,0,14953
2022-04-23,2,8993,122,3785,1965,0,0,14865
2022-04-23,3,9158,122,3459,2187,0,0,14926
2022-04-23,4,9255,122,3341,2268,0,0,14986
2022-04-23,5,9256,122,3378,2306,2,0,15064
2022-04-23,6,9260,122,3434,2661,3,0,15480
2022-04-23,7,9257,122,3638,2495,30,0,15542
2022-04-23,8,9251,121,3906,2747,90,0,16115
2022-04-23,9,9245,121,4157,2696,109,0,16328
2022-04-23,10,9233,121,4785,2547,124,0,16810
2022-04-23,11,9190,122,5141,2281,157,0,16891
2022-04-23,12,9329,122,5042,2380,200,0,17073
2022-04-23,13,9437,122,4650,2112,289,12,16622
2022-04-23,14,9453,125,3803,2207,305,46,15939
2022-04-23,15,9455,124,3808,2372,265,56,16080
2022-04-23,16,9450,122,4219,2531,202,56,16580
2022-04-23,17,9449,121,4572,2749,132,55,17078
2022-04-23,18,9452,121,4407,2901,57,45,16983
2022-04-23,19,9446,121,4625,2839,11,0,17042
2022-04-23,20,9439,121,4671,3076,0,0,17307
2022-04-23,21,9456,122,4583,3180,0,0,17341
2022-04-23,22,9470,121,4112,3144,19,0,16866
2022-04-23,23,9467,122,3639,2627,19,0,15874
2022-04-23,24,9481,123,3628,1997,0,0,15229
2022-04-24,1,9473,122,3503,1647,0,1,14746
2022-04-24,2,9478,123,3446,1675,0,0,14722
2022-04-24,3,9475,122,3442,1567,0,0,14606
2022-04-24,4,9476,122,3427,1512,0,0,14537
2022-04-24,5,9469,122,3434,979,1,0,14005
2022-04-24,6,9477,122,3405,1331,3,0,14338
2022-04-24,7,9461,122,3483,1522,37,0,14625
2022-04-24,8,9449,122,3402,1704,111,0,14788
2022-04-24,9,9446,121,3386,1720,205,0,14878
2022-04-24,10,9583,121,3428,1465,335,0,14932
2022-04-24,11,9640,122,3406,1318,394,0,14880
2022-04-24,12,9641,122,3412,1155,418,0,14748
2022-04-24,13,9640,125,3355,917,412,0,14449
2022-04-24,14,9639,123,3438,736,359,2,14297
2022-04-24,15,9632,125,3545,695,319,7,14323
2022-04-24,16,9620,124,3796,1100,285,17,14942
2022-04-24,17,9625,125,4134,1570,197,48,15699
2022-04-24,18,9626,125,4210,2132,75,55,16223
2022-04-24,19,9619,123,4302,2409,18,56,16527
2022-04-24,20,9616,123,4377,2498,0,55,16669
2022-04-24,21,9621,123,4549,2215,0,47,16555
2022-04-24,22,9674,123,4161,1914,0,40,15912
2022-04-24,23,9682,122,3815,1620,0,1,15240
2022-04-24,24,9690,123,3679,1161,0,0,14653
2022-04-25,1,9702,123,3409,735,0,0,13969
2022-04-25,2,9707,125,3455,612,0,0,13899
2022-04-25,3,9708,142,3361,697,0,0,13908
2022-04-25,4,9706,162,3455,776,0,0,14099
2022-04-25,5,9713,176,3414,1129,0,1,14433
2022-04-25,6,9713,183,3986,1325,3,1,15211
2022-04-25,7,9710,213,5163,1219,30,0,16335
2022-04-25,8,9712,337,5205,887,87,3,16231
2022-04-25,9,9707,337,4859,597,173,16,15689
2022-04-25,10,9711,492,5133,613,234,15,16198
2022-04-25,11,9711,616,5141,702,164,18,16352
2022-04-25,12,9708,646,5132,748,163,17,16414
2022-04-25,13,9708,721,5355,641,139,13,16577
2022-04-25,14,9706,825,5322,632,190,9,16684
2022-04-25,15,9631,794,5288,535,164,10,16422
2022-04-25,16,9598,941,5640,510,89,3,16781
2022-04-25,17,9654,1127,5402,609,54,9,16855
2022-04-25,18,9699,1086,5245,384,44,10,16468
2022-04-25,19,9698,837,5194,711,8,3,16451
2022-04-25,20,9701,805,4830,988,0,0,16324
2022-04-25,21,9693,470,4839,1322,0,0,16324
2022-04-25,22,9687,365,4572,1564,0,0,16188
2022-04-25,23,9688,364,3966,1887,0,0,15905
2022-04-25,24,9672,363,3597,1491,0,0,15123
2022-04-26,1,9675,364,3455,1041,0,0,14535
2022-04-26,2,9676,364,3429,967,0,0,14436
2022-04-26,3,9693,363,3398,1057,0,0,14511
2022-04-26,4,9701,364,3284,1272,0,0,14621
2022-04-26,5,9607,372,3644,1246,1,0,14870
2022-04-26,6,9596,382,4204,1111,2,0,15295
2022-04-26,7,9598,419,5117,956,28,0,16118
2022-04-26,8,9601,535,4957,953,86,0,16132
2022-04-26,9,9599,564,4808,954,172,0,16097
2022-04-26,10,9606,563,4994,1019,225,0,16407
2022-04-26,11,9630,562,5176,1055,231,0,16654
2022-04-26,12,9710,564,5151,1201,204,0,16830
2022-04-26,13,9712,607,5213,1409,207,0,17148
2022-04-26,14,9705,485,4958,1803,119,0,17070
2022-04-26,15,9700,373,4883,2070,102,0,17128
2022-04-26,16,9701,387,5350,2031,63,0,17532
2022-04-26,17,9692,403,5375,1941,45,0,17456
2022-04-26,18,9696,422,5233,1801,23,0,17175
2022-04-26,19,9700,465,4832,1812,4,0,16813
2022-04-26,20,9701,468,5078,1697,0,0,16944
2022-04-26,21,9698,442,5004,1600,0,0,16744
2022-04-26,22,9698,376,4571,1719,0,3,16367
2022-04-26,23,9699,375,4065,1881,0,9,16029
2022-04-26,24,9694,375,3913,1655,0,0,15637
2022-04-27,1,9702,374,3510,1396,0,0,14982
2022-04-27,2,9698,376,3518,1477,0,0,15069
2022-04-27,3,9699,396,3446,1488,0,0,15029
2022-04-27,4,9696,409,3471,1513,0,0,15089
2022-04-27,5,9693,472,3736,1800,1,0,15702
2022-04-27,6,9693,596,3888,1777,6,0,15960
2022-04-27,7,9688,696,4246,2115,38,0,16783
2022-04-27,8,9683,710,4927,2358,100,0,17778
2022-04-27,9,9681,710,4837,2238,154,0,17620
2022-04-27,10,9683,711,4808,2518,228,1,17949
2022-04-27,11,9697,712,4330,2860,274,0,17873
2022-04-27,12,9692,510,4691,2948,239,0,18080
2022-04-27,13,9693,420,4867,2808,224,0,18012
2022-04-27,14,9694,504,4709,2659,165,0,17731
2022-04-27,15,9687,639,4576,2619,172,0,17693
2022-04-27,16,9687,721,4720,2636,149,0,17913
2022-04-27,17,9690,804,5036,2595,102,0,18227
2022-04-27,18,9694,838,5284,2169,63,0,18048
2022-04-27,19,9693,864,5542,1633,17,0,17749
2022-04-27,20,9695,884,5653,1178,0,0,17410
2022-04-27,21,9702,906,5599,963,0,0,17170
2022-04-27,22,9702,867,5579,721,0,0,16869
2022-04-27,23,9703,460,5078,847,0,0,16088
2022-04-27,24,9708,382,4636,885,0,0,15611
2022-04-28,1,9704,373,4729,853,0,0,15659
2022-04-28,2,9708,373,4455,905,0,0,15441
2022-04-28,3,9711,374,4489,927,0,0,15501
2022-04-28,4,9708,374,4541,900,0,0,15523
2022-04-28,5,9709,370,4467,883,1,0,15430
2022-04-28,6,9711,374,5034,816,7,0,15942
2022-04-28,7,9711,418,5517,706,57,0,16409
2022-04-28,8,9705,504,5550,444,199,0,16402
2022-04-28,9,9712,511,5062,364,334,1,15984
2022-04-28,10,9711,431,5104,393,412,1,16052
2022-04-28,11,9709,370,5254,437,431,1,16202
2022-04-28,12,9716,377,5061,560,433,0,16147
2022-04-28,13,9712,387,4860,718,431,0,16108
2022-04-28,14,9712,522,4254,676,427,1,15592
2022-04-28,15,9712,798,4019,530,420,0,15479
2022-04-28,16,9712,977,4098,730,376,4,15897
2022-04-28,17,9715,976,4446,888,257,2,16284
2022-04-28,18,9714,977,4585,881,114,0,16271
2022-04-28,19,9712,982,4998,812,22,0,16526
2022-04-28,20,9705,1011,5587,642,1,0,16946
2022-04-28,21,9708,975,5596,543,0,0,16822
2022-04-28,22,9711,548,5469,520,0,0,16248
2022-04-28,23,9715,372,4919,592,0,0,15598
2022-04-28,24,9711,363,4618,678,0,0,15370
2022-04-29,1,9715,364,4368,689,0,0,15136
2022-04-29,2,9720,363,4217,863,0,0,15163
2022-04-29,3,9717,365,4105,1010,0,0,15197
2022-04-29,4,9721,367,4224,915,0,0,15227
2022-04-29,5,9717,381,4323,1044,0,2,15467
2022-04-29,6,9724,437,4244,1177,8,10,15600
2022-04-29,7,9724,549,4699,1173,65,5,16215
2022-04-29,8,9718,565,5270,775,191,5,16524
2022-04-29,9,9724,561,5015,706,330,3,16339
2022-04-29,10,9721,561,4760,762,410,4,16218
2022-04-29,11,9718,561,4796,683,430,0,16188
2022-04-29,12,9718,563,4789,560,433,0,16063
2022-04-29,13,9722,453,4828,559,433,0,15995
2022-04-29,14,9718,373,4492,666,433,0,15682
2022-04-29,15,9729,470,4130,653,423,0,15405
2022-04-29,16,9725,627,4090,675,368,0,15485
2022-04-29,17,9723,781,4472,817,249,0,16042
2022-04-29,18,9730,633,4904,830,110,0,16207
2022-04-29,19,9734,545,5155,734,20,0,16188
2022-04-29,20,9731,544,5355,784,0,1,16415
2022-04-29,21,9729,543,5298,1055,0,0,16625
2022-04-29,22,9727,545,4936,1247,0,0,16455
2022-04-29,23,9730,151,4175,1333,0,0,15389
2022-04-29,24,9720,68,3834,1384,0,0,15006
2022-04-30,1,8916,153,3933,1432,0,0,14434
2022-04-30,2,8919,119,3565,1709,0,0,14312
2022-04-30,3,8910,91,3566,1546,0,0,14113
2022-04-30,4,8906,92,3619,1686,0,0,14303
2022-04-30,5,8925,106,3615,2060,1,0,14707
2022-04-30,6,8930,152,3691,2272,9,0,15054
2022-04-30,7,8936,240,3867,1943,62,0,15048
2022-04-30,8,8935,365,4168,1789,188,0,15445
2022-04-30,9,8938,364,4367,1550,308,0,15527
2022-04-30,10,8943,365,4097,1404,379,0,15188
2022-04-30,11,8942,365,4066,1428,400,7,15208
2022-04-30,12,8937,364,3911,1622,416,36,15286
2022-04-30,13,8942,364,3790,1364,426,50,14936
2022-04-30,14,8949,365,3705,1050,404,50,14523
2022-04-30,15,8959,365,3714,1106,370,49,14563
2022-04-30,16,8953,366,3878,1206,313,48,14764
2022-04-30,17,8949,365,4333,1432,203,6,15288
2022-04-30,18,8948,316,4421,1733,99,0,15517
2022-04-30,19,8948,328,4469,2074,28,0,15847
2022-04-30,20,8946,337,4552,2562,0,0,16397
2022-04-30,21,8946,339,4387,2447,0,0,16119
2022-04-30,22,8950,364,4336,1964,0,0,15614
2022-04-30,23,8955,365,3904,1739,0,0,14963
2022-04-30,24,8956,364,3772,1067,0,0,14159
2022-05-01,1,8958,365,3580,812,0,0,13715
2022-05-01,2,8959,365,3495,543,0,0,13362
2022-05-01,3,8961,364,3602,449,0,0,13376
2022-05-01,4,8962,365,3627,634,0,0,13588
2022-05-01,5,8962,364,3590,827,1,0,13744
2022-05-01,6,8961,365,3665,881,9,0,13881
2022-05-01,7,8957,365,3879,1149,39,0,14389
2022-05-01,8,8948,365,3873,1234,94,0,14514
2022-05-01,9,8952,365,3870,1422,165,1,14775
2022-05-01,10,8941,365,3987,1627,213,1,15134
2022-05-01,11,8943,365,3760,2327,231,0,15626
2022-05-01,12,8966,365,3708,2329,267,0,15635
2022-05-01,13,8980,365,3802,2139,245,0,15531
2022-05-01,14,8976,368,3834,2138,221,0,15537
2022-05-01,15,8972,367,3894,2198,228,0,15659
2022-05-01,16,8979,367,4113,2316,179,1,15955
2022-05-01,17,8976,367,4605,2447,109,2,16506
2022-05-01,18,8978,367,5049,2084,56,2,16536
2022-05-01,19,8975,367,5487,1888,14,1,16732
2022-05-01,20,8971,367,5897,1671,0,4,16910
2022-05-01,21,8979,366,6003,1319,0,6,16673
2022-05-01,22,8960,384,5560,1017,0,5,15926
2022-05-01,23,8969,366,4864,970,0,1,15170
2022-05-01,24,9186,366,3875,992,0,8,14427
2022-05-02,1,9447,366,3594,671,0,10,14088
2022-05-02,2,9429,366,3551,679,0,11,14036
2022-05-02,3,9435,366,3612,485,0,8,13906
2022-05-02,4,9441,366,3705,626,0,1,14139
2022-05-02,5,9450,364,3673,1035,0,0,14522
2022-05-02,6,9459,363,4648,1033,1,0,15504
2022-05-02,7,9463,433,5719,959,17,0,16591
2022-05-02,8,9458,462,5900,947,43,0,16810
2022-05-02,9,9465,380,5647,1058,52,1,16603
2022-05-02,10,9454,366,5567,1122,103,1,16613
2022-05-02,11,9453,376,5266,1321,118,1,16535
2022-05-02,12,9451,404,5408,1422,96,1,16782
2022-05-02,13,9446,527,5340,1316,125,0,16754
2022-05-02,14,9449,539,5549,1217,128,0,16882
2022-05-02,15,9440,580,5622,1191,91,0,16924
2022-05-02,16,9445,712,5809,831,94,0,16891
2022-05-02,17,9430,939,5916,625,69,0,16979
2022-05-02,18,9436,1001,5959,522,33,0,16951
2022-05-02,19,9442,1026,5403,557,6,0,16434
2022-05-02,20,9434,1047,5740,458,0,0,16679
2022-05-02,21,9430,1118,5703,310,0,0,16561
2022-05-02,22,9445,1122,5260,304,0,0,16131
2022-05-02,23,9447,813,5125,220,0,0,15605
2022-05-02,24,9448,693,4912,174,0,0,15227
2022-05-03,1,9452,693,4460,144,0,0,14749
2022-05-03,2,9535,693,4476,114,0,0,14818
2022-05-03,3,9703,631,4032,78,0,0,14444
2022-05-03,4,9729,366,4407,190,0,0,14692
2022-05-03,5,9741,366,4516,210,0,19,14852
2022-05-03,6,9762,366,4535,397,2,36,15098
2022-05-03,7,9769,367,5030,517,26,36,15745
2022-05-03,8,9764,367,5108,721,77,37,16074
2022-05-03,9,9767,369,4894,851,115,33,16029
2022-05-03,10,9772,370,4869,928,140,30,16109
2022-05-03,11,9776,369,5132,1196,116,36,16625
2022-05-03,12,9774,370,4975,1233,136,43,16531
2022-05-03,13,9778,376,5130,1405,172,55,16916
2022-05-03,14,9833,432,4936,1653,146,78,17078
2022-05-03,15,9849,497,4870,1713,92,81,17102
2022-05-03,16,9830,581,5277,1540,60,86,17374
2022-05-03,17,9827,782,5843,979,27,88,17546
2022-05-03,18,9829,868,5580,863,20,89,17249
2022-05-03,19,9827,807,5172,1007,6,88,16907
2022-05-03,20,9828,576,5122,1454,0,88,17068
2022-05-03,21,9824,573,5106,1318,0,86,16907
2022-05-03,22,9814,425,5100,1047,0,70,16456
2022-05-03,23,9834,369,4901,931,0,18,16053
2022-05-03,24,9839,367,4457,588,0,14,15265
2022-05-04,1,9842,368,4161,392,0,13,14776
2022-05-04,2,9708,370,3938,457,0,9,14482
2022-05-04,3,9555,370,3844,674,0,18,14461
2022-05-04,4,9559,370,3898,498,0,16,14341
2022-05-04,5,9575,369,3928,1149,0,17,15038
2022-05-04,6,9843,369,3991,1721,2,5,15931
2022-05-04,7,9859,370,4525,2448,12,4,17218
2022-05-04,8,9692,373,4851,2741,38,1,17696
2022-05-04,9,9706,372,5023,2434,69,0,17604
2022-05-04,10,9859,373,4736,2353,115,0,17436
2022-05-04,11,9865,384,4727,1992,160,2,17130
2022-05-04,12,9885,420,4742,1624,246,0,16917
2022-05-04,13,9887,423,4920,1156,322,15,16723
2022-05-04,14,9883,450,4805,1044,311,44,16537
2022-05-04,15,9885,480,4826,851,262,51,16355
2022-05-04,16,9874,618,5007,771,245,51,16566
2022-05-04,17,9878,742,4905,989,188,51,16753
2022-05-04,18,9877,593,5158,1167,93,39,16927
2022-05-04,19,9879,504,5485,932,23,0,16823
2022-05-04,20,9885,508,5634,805,1,0,16833
2022-05-04,21,9876,503,5713,979,0,0,17071
2022-05-04,22,9887,194,5670,974,0,0,16725
2022-05-04,23,9891,128,4884,891,0,0,15794
2022-05-04,24,9904,130,4418,790,0,0,15242
2022-05-05,1,9904,130,3977,760,0,0,14771
2022-05-05,2,9895,139,3804,725,0,0,14563
2022-05-05,3,9906,141,3745,651,0,1,14444
2022-05-05,4,9903,189,3782,768,0,1,14643
2022-05-05,5,9899,320,4152,713,0,2,15086
2022-05-05,6,9895,319,4998,744,12,27,15995
2022-05-05,7,9899,319,5141,862,66,50,16337
2022-05-05,8,9898,320,5297,472,182,53,16222
2022-05-05,9,9906,194,5524,220,299,53,16196
2022-05-05,10,9904,149,4744,298,367,53,15515
2022-05-05,11,9901,130,5003,206,388,53,15681
2022-05-05,12,9904,135,5335,216,396,13,15999
2022-05-05,13,9920,207,5227,225,398,0,15977
2022-05-05,14,9915,353,4885,249,381,0,15783
2022-05-05,15,9922,713,4885,242,322,0,16084
2022-05-05,16,9926,998,5087,268,226,0,16505
2022-05-05,17,9921,1117,5362,372,154,0,16926
2022-05-05,18,9919,1119,5338,386,69,0,16831
2022-05-05,19,9933,1119,5562,445,23,0,17082
2022-05-05,20,9756,1120,5670,640,1,0,17187
2022-05-05,21,9235,1116,5738,706,0,0,16795
2022-05-05,22,9162,793,5465,729,0,0,16149
2022-05-05,23,9163,256,5403,788,0,0,15610
2022-05-05,24,9161,128,5122,752,0,0,15163
2022-05-06,1,9179,129,4806,650,0,0,14764
2022-05-06,2,9185,128,4381,858,0,0,14552
2022-05-06,3,9179,127,3827,1324,0,0,14457
2022-05-06,4,9178,128,3733,1403,0,0,14442
2022-05-06,5,9181,126,3877,1610,1,1,14796
2022-05-06,6,9175,127,4339,2209,10,16,15876
2022-05-06,7,9175,127,4904,2317,45,57,16625
2022-05-06,8,9177,127,5045,2464,117,78,17008
2022-05-06,9,9173,127,5025,2306,176,79,16886
2022-05-06,10,9175,127,4862,2329,235,82,16810
2022-05-06,11,9173,127,4570,2419,277,82,16648
2022-05-06,12,9167,127,4582,2301,309,56,16542
2022-05-06,13,9166,141,4336,2265,314,25,16247
2022-05-06,14,9165,151,4138,2055,293,23,15825
2022-05-06,15,9159,156,4080,2205,252,14,15866
2022-05-06,16,9156,154,4201,2305,236,4,16056
2022-05-06,17,9151,154,4321,2616,166,0,16408
2022-05-06,18,9145,154,4667,2774,88,0,16828
2022-05-06,19,9143,128,4682,3051,30,5,17039
2022-05-06,20,9144,127,4693,3167,2,10,17143
2022-05-06,21,9143,127,4746,3405,0,4,17425
2022-05-06,22,9146,127,4346,2894,0,5,16518
2022-05-06,23,9144,127,4054,2095,0,5,15425
2022-05-06,24,9144,127,3881,1299,0,2,14453
2022-05-07,1,9149,128,3705,1192,0,4,14178
2022-05-07,2,9155,127,3670,974,0,12,13938
2022-05-07,3,9153,127,3639,701,0,6,13626
2022-05-07,4,9157,127,3650,807,0,0,13741
2022-05-07,5,9165,127,3646,1035,1,0,13974
2022-05-07,6,9177,127,3811,1132,12,0,14259
2022-05-07,7,9177,127,4039,1160,66,0,14569
2022-05-07,8,9186,127,4010,1212,188,0,14723
2022-05-07,9,9183,127,4081,966,239,0,14596
2022-05-07,10,9187,127,4132,882,327,0,14655
2022-05-07,11,9182,127,3988,950,429,0,14676
2022-05-07,12,9187,126,3838,983,433,0,14567
2022-05-07,13,9188,126,3829,778,412,0,14333
2022-05-07,14,9194,127,3811,683,302,0,14117
2022-05-07,15,9200,127,3832,693,310,0,14162
2022-05-07,16,9203,128,4018,888,375,0,14612
2022-05-07,17,9205,127,4283,1163,260,0,15038
2022-05-07,18,9204,128,4512,1445,118,0,15407
2022-05-07,19,9204,128,4564,1615,24,0,15535
2022-05-07,20,9201,128,5121,1519,1,0,15970
2022-05-07,21,9204,128,5149,1615,0,0,16096
2022-05-07,22,9206,128,4688,1514,0,0,15536
2022-05-07,23,9207,127,4430,1428,0,0,15192
2022-05-07,24,9219,126,4127,924,0,0,14396
2022-05-08,1,9221,126,3863,1268,0,0,14478
2022-05-08,2,9223,126,3817,1199,0,0,14365
2022-05-08,3,9225,126,3753,1242,0,0,14346
2022-05-08,4,9221,127,3713,1278,0,0,14339
2022-05-08,5,9219,127,3710,1425,0,0,14481
2022-05-08,6,9211,127,3986,1237,10,0,14571
2022-05-08,7,9213,135,4335,1087,66,0,14836
2022-05-08,8,9204,160,4523,724,197,0,14808
2022-05-08,9,9218,203,4679,412,327,0,14839
2022-05-08,10,9215,234,4339,333,383,0,14504
2022-05-08,11,9216,234,4322,440,429,0,14641
2022-05-08,12,9213,234,4126,566,433,0,14572
2022-05-08,13,9210,234,4219,495,433,0,14591
2022-05-08,14,9209,252,4167,383,429,0,14440
2022-05-08,15,9209,289,4245,395,337,0,14475
2022-05-08,16,9205,308,4400,556,332,0,14801
2022-05-08,17,9208,345,4565,1025,247,0,15390
2022-05-08,18,9209,487,4741,1289,114,0,15840
2022-05-08,19,9210,489,4775,1566,25,0,16065
2022-05-08,20,9207,489,5006,1800,0,0,16502
2022-05-08,21,9204,489,4793,2127,0,0,16613
2022-05-08,22,9206,484,4419,2417,0,0,16526
2022-05-08,23,9209,484,4016,2155,0,0,15864
2022-05-08,24,9201,353,3892,1650,0,0,15096
2022-05-09,1,9204,149,3777,1355,0,0,14485
2022-05-09,2,9206,129,3802,1254,0,1,14392
2022-05-09,3,9214,129,3745,1231,0,1,14320
2022-05-09,4,9217,129,3790,1485,0,0,14621
2022-05-09,5,9220,128,3757,2071,1,0,15177
2022-05-09,6,9210,126,4093,2104,9,0,15542
2022-05-09,7,9207,125,4664,2115,65,0,16176
2022-05-09,8,9164,215,5144,1480,195,0,16198
2022-05-09,9,8396,486,5448,1325,312,0,15967
2022-05-09,10,8354,508,4756,1471,383,0,15472
2022-05-09,11,7595,376,5068,1960,422,0,15421
2022-05-09,12,7593,330,4889,2162,432,0,15406
2022-05-09,13,7591,485,5006,2222,431,0,15735
2022-05-09,14,7558,653,4621,2238,430,0,15500
2022-05-09,15,6778,716,5570,2252,413,8,15737
2022-05-09,16,6776,835,5900,2103,353,13,15980
2022-05-09,17,6773,1037,5853,2553,233,38,16487
2022-05-09,18,6773,893,5166,2966,107,49,15954
2022-05-09,19,6775,768,5235,2927,27,47,15779
2022-05-09,20,6771,480,5314,3189,2,48,15804
2022-05-09,21,6773,398,5297,3587,0,48,16103
2022-05-09,22,6774,368,4797,3592,0,48,15579
2022-05-09,23,6775,231,4374,3819,0,9,15208
2022-05-09,24,6772,139,4308,2654,0,0,13873
2022-05-10,1,6773,140,4032,2362,0,0,13307
2022-05-10,2,6771,140,3870,2659,0,0,13440
2022-05-10,3,6770,139,3878,2656,0,0,13443
2022-05-10,4,6766,139,4086,2786,0,0,13777
2022-05-10,5,6768,138,4301,3131,1,0,14339
2022-05-10,6,6777,139,4324,3344,13,0,14597
2022-05-10,7,6774,138,4946,3335,69,0,15262
2022-05-10,8,6771,143,5400,3280,166,0,15760
2022-05-10,9,6775,158,5453,3180,276,0,15842
2022-05-10,10,6774,168,5521,3062,351,0,15876
2022-05-10,11,6771,249,5446,2954,395,0,15815
2022-05-10,12,6766,317,5485,2502,424,11,15505
2022-05-10,13,6762,624,5756,2077,423,44,15686
2022-05-10,14,6763,588,5504,1770,396,54,15075
2022-05-10,15,6762,787,5535,1645,398,50,15177
2022-05-10,16,6766,1329,5245,1815,331,49,15535
2022-05-10,17,6763,1333,5488,2069,200,49,15902
2022-05-10,18,6762,1294,5571,2239,102,49,16017
2022-05-10,19,6761,1283,5859,2230,29,50,16212
2022-05-10,20,6763,1294,6083,2238,3,52,16433
2022-05-10,21,6764,1073,5914,2681,0,53,16485
2022-05-10,22,6763,475,5594,2913,0,52,15797
2022-05-10,23,6763,140,5182,2997,0,12,15094
2022-05-10,24,6765,136,5117,2789,0,0,14807
2022-05-11,1,6769,136,5261,2300,0,0,14466
2022-05-11,2,6775,159,5250,2164,0,0,14348
2022-05-11,3,6774,153,4602,2272,0,0,13801
2022-05-11,4,6778,267,4778,2049,0,0,13872
2022-05-11,5,6772,578,4449,1810,1,0,13610
2022-05-11,6,6773,965,4760,1704,12,0,14214
2022-05-11,7,6771,1120,5361,1537,63,0,14852
2022-05-11,8,6767,1102,5367,1336,173,0,14745
2022-05-11,9,6770,1266,5819,739,272,0,14866
2022-05-11,10,6765,1322,5692,473,369,0,14621
2022-05-11,11,6770,1417,5677,314,377,0,14555
2022-05-11,12,6764,1475,5276,247,402,0,14164
2022-05-11,13,6769,1538,5533,352,385,3,14580
2022-05-11,14,6772,1676,5220,495,392,34,14589
2022-05-11,15,6774,2054,5334,170,367,49,14748
2022-05-11,16,6770,2992,5516,106,292,48,15724
2022-05-11,17,6774,3381,5580,76,212,48,16071
2022-05-11,18,6773,3018,5634,188,102,50,15765
2022-05-11,19,6774,2631,5922,352,24,49,15752
2022-05-11,20,6769,2508,6128,626,1,59,16091
2022-05-11,21,6771,2550,6064,850,0,53,16288
2022-05-11,22,6773,1850,5801,1221,0,53,15698
2022-05-11,23,6777,1042,5299,1264,0,54,14436
2022-05-11,24,6777,719,5134,1183,0,54,13867
2022-05-12,1,6777,382,5043,1131,0,54,13387
2022-05-12,2,6779,346,5199,749,0,47,13120
2022-05-12,3,6781,399,5398,547,0,47,13172
2022-05-12,4,6783,607,5301,521,0,47,13259
2022-05-12,5,6780,896,4796,999,0,47,13518
2022-05-12,6,6777,1291,4367,1427,13,47,13922
2022-05-12,7,6779,1517,5000,1387,58,47,14788
2022-05-12,8,6773,1786,5075,1013,148,47,14842
2022-05-12,9,6777,2029,5641,325,252,47,15071
2022-05-12,10,6773,2420,5272,307,336,12,15120
2022-05-12,11,6759,2759,4680,367,375,0,14940
2022-05-12,12,6751,2522,5224,393,384,0,15274
2022-05-12,13,6756,2512,5218,678,384,1,15549
2022-05-12,14,6763,2513,5287,826,384,6,15779
2022-05-12,15,6765,2583,5574,844,344,40,16150
2022-05-12,16,6756,2780,5896,657,273,62,16424
2022-05-12,17,6754,3524,6073,742,181,59,17333
2022-05-12,18,6758,3666,6176,866,97,50,17613
2022-05-12,19,6756,3403,6231,994,29,63,17476
2022-05-12,20,6760,3237,6233,1100,4,85,17419
2022-05-12,21,6759,2631,5901,1449,0,93,16833
2022-05-12,22,6760,1317,5876,1705,0,94,15752
2022-05-12,23,6763,686,5514,2132,0,108,15203
2022-05-12,24,6764,222,4859,2439,0,113,14397
2022-05-13,1,6771,140,4649,2729,0,69,14358
2022-05-13,2,6773,140,4335,2804,0,65,14117
2022-05-13,3,6776,140,4432,2578,0,108,14034
2022-05-13,4,6775,145,4389,2569,0,121,13999
2022-05-13,5,6769,152,4461,2550,1,121,14054
2022-05-13,6,6768,186,4614,2478,7,75,14128
2022-05-13,7,6767,358,5266,2295,55,55,14796
2022-05-13,8,6764,792,5456,1732,154,49,14947
2022-05-13,9,6759,1118,5523,1653,239,48,15340
2022-05-13,10,6753,1536,5293,1399,347,48,15376
2022-05-13,11,6754,2260,5554,1163,371,48,16150
2022-05-13,12,6753,2668,5751,986,353,105,16616
2022-05-13,13,6753,2971,5898,595,353,179,16749
2022-05-13,14,6760,3214,5958,517,346,180,16975
2022-05-13,15,6759,2957,5913,523,318,115,16585
2022-05-13,16,6759,2942,5918,564,261,50,16494
2022-05-13,17,6756,3362,6001,630,173,51,16973
2022-05-13,18,6758,3039,6119,785,84,50,16835
2022-05-13,19,6760,2817,6044,899,27,49,16596
2022-05-13,20,6760,2818,6153,977,3,49,16760
2022-05-13,21,6757,2747,6172,1199,0,49,16924
2022-05-13,22,6792,2116,5379,1447,0,49,15783
2022-05-13,23,6809,824,4980,1888,0,49,14550
2022-05-13,24,6827,218,5018,1884,0,49,13996
2022-05-14,1,6831,137,5121,1751,0,49,13889
2022-05-14,2,6837,167,5407,1551,0,15,13977
2022-05-14,3,6827,181,5198,1593,0,0,13799
2022-05-14,4,6826,193,5271,1424,0,0,13714
2022-05-14,5,6836,274,5232,1467,0,0,13809
2022-05-14,6,6864,463,4733,1521,6,0,13587
2022-05-14,7,6864,636,5169,1286,56,0,14011
2022-05-14,8,6859,913,5710,884,142,1,14509
2022-05-14,9,6863,1175,5813,743,277,19,14890
2022-05-14,10,6862,1370,5741,609,369,55,15006
2022-05-14,11,6871,1579,5751,442,387,143,15173
2022-05-14,12,6862,2002,5834,317,380,174,15569
2022-05-14,13,6852,2542,5733,246,409,160,15942
2022-05-14,14,6859,2605,5746,331,412,143,16096
2022-05-14,15,6855,2943,5839,403,372,109,16521
2022-05-14,16,6858,3297,5865,483,284,109,16896
2022-05-14,17,6858,3427,5938,488,189,108,17008
2022-05-14,18,6909,3193,6017,441,89,86,16735
2022-05-14,19,6961,3478,6105,335,18,54,16951
2022-05-14,20,6959,3105,6109,595,2,14,16784
2022-05-14,21,6995,3272,6143,506,0,1,16917
2022-05-14,22,7017,2362,5707,828,0,8,15922
2022-05-14,23,7017,1485,5758,510,0,16,14786
2022-05-14,24,7017,535,5811,317,0,7,13687
2022-05-15,1,7024,457,5443,314,0,0,13238
2022-05-15,2,7033,429,5095,372,0,0,12929
2022-05-15,3,7123,167,5182,417,0,0,12889
2022-05-15,4,7158,199,5266,371,0,0,12994
2022-05-15,5,7161,228,5318,305,2,0,13014
2022-05-15,6,7155,428,5136,303,7,0,13029
2022-05-15,7,7156,787,4823,265,42,22,13095
2022-05-15,8,6870,1179,5250,228,98,49,13674
2022-05-15,9,6261,1369,5883,154,173,51,13891
2022-05-15,10,6259,1402,5689,181,275,51,13857
2022-05-15,11,6262,1739,5692,240,362,77,14372
2022-05-15,12,6261,1904,5615,374,373,62,14589
2022-05-15,13,6263,2367,4944,549,377,53,14553
2022-05-15,14,6257,2469,5611,714,312,53,15416
2022-05-15,15,6281,2451,5490,796,327,53,15398
2022-05-15,16,6288,3043,5889,982,309,58,16569
2022-05-15,17,6288,3217,6259,1008,217,60,17049
2022-05-15,18,6294,3748,6131,968,98,59,17298
2022-05-15,19,6301,3932,6223,743,22,56,17277
2022-05-15,20,6292,3476,6190,875,2,60,16895
2022-05-15,21,6304,3303,6056,929,0,91,16683
2022-05-15,22,6333,2523,5939,671,0,90,15556
2022-05-15,23,6340,2130,5708,486,0,92,14756
2022-05-15,24,6339,1223,4664,1058,0,18,13302
2022-05-16,1,6336,536,4528,1346,0,0,12746
2022-05-16,2,6334,384,4487,1512,0,0,12717
2022-05-16,3,6338,388,4835,1392,0,0,12953
2022-05-16,4,6351,532,5139,916,0,0,12938
2022-05-16,5,6384,643,4727,820,0,0,12574
2022-05-16,6,6392,948,5232,728,10,1,13311
2022-05-16,7,6391,1431,5274,1228,36,1,14361
2022-05-16,8,6393,1976,5607,894,87,0,14957
2022-05-16,9,6395,2093,5734,695,177,0,15094
2022-05-16,10,6390,2429,5748,441,202,2,15212
2022-05-16,11,6393,2764,5635,416,190,3,15401
2022-05-16,12,6394,2849,5628,489,160,9,15529
2022-05-16,13,6383,2779,5460,693,132,8,15455
2022-05-16,14,6379,2452,5494,801,170,1,15297
2022-05-16,15,6375,2286,5379,1010,163,0,15213
2022-05-16,16,6367,2343,5435,999,184,1,15329
2022-05-16,17,6375,2376,5601,962,118,0,15432
2022-05-16,18,6391,2249,5617,1034,67,0,15358
2022-05-16,19,6395,2229,5314,1063,19,0,15020
2022-05-16,20,6397,1760,5455,1222,2,0,14836
2022-05-16,21,6400,1532,5295,1341,0,0,14568
2022-05-16,22,6392,1041,5306,1542,0,0,14281
2022-05-16,23,6400,678,5103,1798,0,0,13979
2022-05-16,24,6399,462,4713,2000,0,0,13574
2022-05-17,1,6408,370,4642,2138,0,0,13558
2022-05-17,2,6405,369,4456,2469,0,0,13699
2022-05-17,3,6405,370,4388,2378,0,0,13541
2022-05-17,4,6404,370,4383,2090,0,0,13247
2022-05-17,5,6399,378,4961,2189,3,0,13930
2022-05-17,6,6394,422,5114,2118,9,0,14057
2022-05-17,7,6394,512,5177,2196,62,15,14356
2022-05-17,8,6392,615,5028,2134,138,42,14349
2022-05-17,9,6397,879,4945,1848,260,56,14385
2022-05-17,10,6396,1128,5359,1612,288,57,14840
2022-05-17,11,6388,1372,4858,1663,317,71,14669
2022-05-17,12,6394,1368,4631,1850,312,71,14626
2022-05-17,13,6395,1380,4702,1753,295,59,14584
2022-05-17,14,6391,1502,4799,1536,294,54,14576
2022-05-17,15,6390,1734,4927,1385,259,56,14751
2022-05-17,16,6389,2007,4915,1272,222,56,14861
2022-05-17,17,6390,2007,4899,1002,202,57,14557
2022-05-17,18,6391,1729,5445,1162,108,56,14891
2022-05-17,19,6399,1575,5650,986,31,56,14697
2022-05-17,20,6398,1583,5638,715,5,54,14393
2022-05-17,21,6392,1755,5793,524,0,50,14514
2022-05-17,22,6395,1666,5777,423,0,49,14310
2022-05-17,23,6407,945,5694,392,0,11,13449
2022-05-17,24,6405,425,4970,471,0,0,12271
2022-05-18,1,6398,367,4982,512,0,0,12259
2022-05-18,2,6395,373,4897,483,0,0,12148
2022-05-18,3,6402,390,4954,408,0,0,12154
2022-05-18,4,6401,498,4749,365,0,0,12013
2022-05-18,5,6408,658,4616,352,3,3,12040
2022-05-18,6,6413,988,4965,389,15,4,12774
2022-05-18,7,6409,987,5616,417,68,24,13521
2022-05-18,8,6406,985,5808,237,169,53,13658
2022-05-18,9,6406,1002,5757,189,265,70,13689
2022-05-18,10,6397,989,5589,313,288,71,13647
2022-05-18,11,6398,1045,5576,435,294,71,13819
2022-05-18,12,6407,1001,5440,680,268,71,13867
2022-05-18,13,6405,1149,5653,567,245,70,14089
2022-05-18,14,6407,1221,5668,490,216,71,14073
2022-05-18,15,6406,1226,5501,709,208,70,14120
2022-05-18,16,6407,1292,5203,926,174,71,14073
2022-05-18,17,6406,1427,5555,1023,120,69,14600
2022-05-18,18,6405,1543,5570,1167,55,34,14774
2022-05-18,19,6406,1564,5917,975,22,10,14894
2022-05-18,20,6403,1625,5987,983,1,48,15047
2022-05-18,21,6400,1529,5933,813,0,15,14690
2022-05-18,22,6398,1239,6097,641,0,0,14375
2022-05-18,23,6401,1051,5875,596,0,0,13923
2022-05-18,24,6404,530,5469,536,0,0,12939
2022-05-19,1,6405,383,5001,509,0,0,12298
2022-05-19,2,6408,384,5043,529,0,0,12364
2022-05-19,3,6394,381,5121,470,0,0,12366
2022-05-19,4,6405,491,5123,484,0,0,12503
2022-05-19,5,6395,643,4781,497,1,11,12328
2022-05-19,6,6418,813,5069,632,2,44,12978
2022-05-19,7,6421,949,5670,741,13,80,13874
2022-05-19,8,6420,1139,5638,867,25,89,14178
2022-05-19,9,6415,1178,5737,801,73,61,14265
2022-05-19,10,6414,1570,5908,730,135,87,14844
2022-05-19,11,6415,1831,5570,593,163,88,14660
2022-05-19,12,6411,1847,5237,793,189,68,14545
2022-05-19,13,6414,1841,4981,886,237,54,14413
2022-05-19,14,6411,1671,4973,892,254,54,14255
2022-05-19,15,6408,1729,5090,1080,261,57,14625
2022-05-19,16,6399,1851,5009,1256,208,48,14771
2022-05-19,17,6394,2021,5237,1116,151,70,14989
2022-05-19,18,6400,2149,5490,883,78,128,15128
2022-05-19,19,6407,2083,5357,749,25,181,14802
2022-05-19,20,6409,2196,5568,730,5,175,15083
2022-05-19,21,6409,2064,5361,1036,0,174,15044
2022-05-19,22,6416,1456,5405,1495,0,120,14892
2022-05-19,23,6414,698,4799,1919,0,52,13882
2022-05-19,24,6419,427,4904,1603,0,9,13362
2022-05-20,1,6418,379,4662,1947,0,0,13406
2022-05-20,2,6422,379,4460,2400,0,0,13661
2022-05-20,3,6413,381,4351,2881,0,0,14026
2022-05-20,4,6408,477,4367,2862,0,0,14114
2022-05-20,5,6210,586,4612,2531,2,0,13941
2022-05-20,6,5908,920,5428,1854,9,0,14119
2022-05-20,7,5907,940,5609,2129,44,0,14629
2022-05-20,8,5908,855,5296,2405,81,0,14545
2022-05-20,9,5903,1050,5313,2114,165,0,14545
2022-05-20,10,5902,1312,5260,2154,321,0,14949
2022-05-20,11,5902,1742,5269,2060,348,0,15321
2022-05-20,12,5899,2017,5279,2663,321,2,16181
2022-05-20,13,5897,1853,5457,3149,297,21,16674
2022-05-20,14,5900,1742,5352,2721,298,48,16061
2022-05-20,15,5893,1654,5123,3177,285,53,16185
2022-05-20,16,5907,1680,5270,3213,231,52,16353
2022-05-20,17,5976,1684,5172,3615,169,56,16672
2022-05-20,18,6077,1661,5385,3376,72,56,16627
2022-05-20,19,6072,1674,5190,3428,30,56,16450
2022-05-20,20,6074,1112,5796,3645,4,64,16695
2022-05-20,21,6071,1017,6001,3574,0,72,16735
2022-05-20,22,6073,821,5437,3561,0,59,15951
2022-05-20,23,6069,608,4888,3024,0,11,14600
2022-05-20,24,6330,415,4828,2589,0,0,14162
2022-05-21,1,6552,374,4786,2530,0,0,14242
2022-05-21,2,6556,374,4567,2938,0,0,14435
2022-05-21,3,6560,375,4904,2731,0,0,14570
2022-05-21,4,6564,381,4839,2589,0,0,14373
2022-05-21,5,6562,399,5006,2272,0,0,14239
2022-05-21,6,6569,549,4997,1848,8,0,13971
2022-05-21,7,6568,750,4940,1791,61,0,14110
2022-05-21,8,6569,1167,5040,1349,136,0,14261
2022-05-21,9,6619,1373,5085,1121,209,3,14410
2022-05-21,10,6722,1390,5167,1622,202,9,15112
2022-05-21,11,6727,1596,5632,1519,291,36,15801
2022-05-21,12,6726,2189,5510,1091,266,59,15841
2022-05-21,13,6719,2267,4788,241,75,56,14146
2022-05-21,14,6334,2240,4723,226,83,56,13662
2022-05-21,15,6202,2136,4957,453,103,53,13904
2022-05-21,16,6202,3036,4924,757,126,54,15099
2022-05-21,17,6207,2696,5241,1289,146,57,15636
2022-05-21,18,6208,2639,5118,854,82,31,14932
2022-05-21,19,6213,2658,5258,429,18,6,14582
2022-05-21,20,6214,2658,4933,493,1,6,14305
2022-05-21,21,6220,2653,4939,410,0,0,14222
2022-05-21,22,6220,2098,5227,354,0,0,13899
2022-05-21,23,6225,1546,5168,293,0,0,13232
2022-05-21,24,6229,1009,5137,161,0,0,12536
2022-05-22,1,6265,488,4936,170,0,0,11859
2022-05-22,2,6275,385,5190,153,0,0,12003
2022-05-22,3,6284,392,4511,264,0,0,11451
2022-05-22,4,6280,393,4301,203,0,0,11177
2022-05-22,5,6270,471,4360,481,2,0,11584
2022-05-22,6,6262,606,4320,628,7,0,11823
2022-05-22,7,6264,823,4703,323,18,0,12131
2022-05-22,8,6261,866,4768,481,69,0,12445
2022-05-22,9,6262,978,4869,1060,109,0,13278
2022-05-22,10,6268,1142,4878,1210,124,0,13622
2022-05-22,11,6280,1435,4982,1142,95,0,13934
2022-05-22,12,6277,1439,5249,839,88,0,13892
2022-05-22,13,6270,1308,5017,603,78,0,13276
2022-05-22,14,6271,1286,4692,511,98,0,12858
2022-05-22,15,6281,1489,4739,174,31,0,12714
2022-05-22,16,6274,1375,4883,352,91,0,12975
2022-05-22,17,6284,1370,4787,186,45,0,12672
2022-05-22,18,6286,1377,4847,317,62,0,12889
2022-05-22,19,6285,1374,4936,128,19,0,12742
2022-05-22,20,6286,1039,5067,322,4,0,12718
2022-05-22,21,6288,951,5425,611,0,0,13275
2022-05-22,22,6290,762,5614,655,0,1,13322
2022-05-22,23,6289,632,4930,473,0,6,12330
2022-05-22,24,6297,475,5143,442,0,9,12366
2022-05-23,1,6306,377,5143,435,0,1,12262
2022-05-23,2,6319,380,5039,429,0,0,12167
2022-05-23,3,6341,378,5124,562,0,0,12405
2022-05-23,4,6359,373,5032,623,1,0,12388
2022-05-23,5,6405,474,5143,641,1,0,12664
2022-05-23,6,6451,604,5253,707,12,0,13027
2022-05-23,7,6492,727,5039,546,53,11,12868
2022-05-23,8,6536,728,4983,304,83,12,12646
2022-05-23,9,6546,729,4994,475,214,7,12965
2022-05-23,10,6541,729,5255,375,229,3,13132
2022-05-23,11,6546,732,5316,497,270,6,13367
2022-05-23,12,6543,735,5373,485,257,3,13396
2022-05-23,13,6539,652,5308,517,233,0,13249
2022-05-23,14,6539,713,5168,616,207,0,13243
2022-05-23,15,6538,869,4915,595,202,0,13119
2022-05-23,16,6615,897,5093,520,171,0,13296
2022-05-23,17,6650,821,5585,558,124,0,13738
2022-05-23,18,6672,843,5787,512,92,0,13906
2022-05-23,19,6673,981,5443,512,43,0,13652
2022-05-23,20,6669,985,5764,448,7,0,13873
2022-05-23,21,6674,985,5818,542,0,0,14019
2022-05-23,22,6675,744,5818,629,0,0,13866
2022-05-23,23,6673,405,5521,724,0,0,13323
2022-05-23,24,6664,370,5336,816,0,0,13186
2022-05-24,1,6709,370,5236,934,0,0,13249
2022-05-24,2,6721,375,5316,853,0,0,13265
2022-05-24,3,6723,421,5570,832,0,0,13546
2022-05-24,4,6736,506,5508,898,0,0,13648
2022-05-24,5,6754,665,5042,904,2,0,13367
2022-05-24,6,6819,850,5148,926,14,0,13757
2022-05-24,7,6838,1063,5367,638,62,0,13968
2022-05-24,8,6843,1227,5571,335,124,0,14100
2022-05-24,9,6876,1243,5443,229,227,0,14018
2022-05-24,10,6894,1186,4987,275,355,0,13697
2022-05-24,11,6937,1166,5213,219,390,0,13925
2022-05-24,12,6971,1167,5127,242,398,0,13905
2022-05-24,13,7015,1169,5207,402,373,0,14166
2022-05-24,14,7017,902,5567,580,364,0,14430
2022-05-24,15,7021,856,5437,783,361,0,14458
2022-05-24,16,7017,972,5250,792,271,0,14302
2022-05-24,17,7014,1068,5466,836,199,0,14583
2022-05-24,18,7014,1074,5514,709,112,0,14423
2022-05-24,19,7019,1079,5767,731,34,0,14630
2022-05-24,20,7020,1103,6069,627,7,0,14826
2022-05-24,21,7032,1208,5986,671,0,0,14897
2022-05-24,22,7047,1064,5333,796,0,0,14240
2022-05-24,23,7063,522,5127,1029,0,0,13741
2022-05-24,24,7204,372,4964,1149,0,0,13689
2022-05-25,1,7247,371,4814,1366,0,0,13798
2022-05-25,2,7245,373,4871,1670,0,0,14159
2022-05-25,3,7249,477,4553,1603,0,0,13882
2022-05-25,4,7229,532,4680,1710,1,0,14152
2022-05-25,5,7228,594,4563,1629,1,0,14015
2022-05-25,6,7233,729,4797,1387,18,0,14164
2022-05-25,7,7243,743,5454,1284,69,0,14793
2022-05-25,8,7230,751,5698,1248,162,0,15089
2022-05-25,9,7231,755,5835,1236,258,0,15315
2022-05-25,10,7231,755,5592,1551,329,0,15458
2022-05-25,11,7232,739,5326,1965,327,0,15589
2022-05-25,12,7284,628,5211,1781,298,0,15202
2022-05-25,13,7292,647,5108,1772,322,0,15141
2022-05-25,14,7296,931,5220,1936,318,0,15701
2022-05-25,15,7296,1067,5345,2260,246,0,16214
2022-05-25,16,7291,1233,5541,2428,198,0,16691
2022-05-25,17,7290,1372,5813,2427,118,0,17020
2022-05-25,18,7289,1368,5650,2395,53,0,16755
2022-05-25,19,7293,1348,5496,2258,18,0,16413
2022-05-25,20,7292,1076,5540,2732,2,0,16642
2022-05-25,21,7286,768,5565,3079,0,0,16698
2022-05-25,22,7286,638,5100,3257,0,0,16281
2022-05-25,23,7280,466,4578,3354,0,0,15678
2022-05-25,24,7284,371,4046,3374,0,0,15075
2022-05-26,1,7284,371,3968,3112,0,0,14735
2022-05-26,2,7277,372,3973,3026,0,0,14648
2022-05-26,3,7281,371,3949,2961,0,8,14570
2022-05-26,4,7280,371,3948,3138,0,8,14745
2022-05-26,5,7284,371,3989,3042,1,13,14700
2022-05-26,6,7296,372,4290,3265,10,18,15251
2022-05-26,7,7329,371,5046,3441,42,22,16251
2022-05-26,8,7422,373,5456,3581,86,21,16939
2022-05-26,9,7522,370,5278,3652,148,4,16974
2022-05-26,10,7500,398,5274,3609,231,2,17014
2022-05-26,11,7475,487,5208,3750,290,0,17210
2022-05-26,12,7478,555,5410,3855,253,0,17551
2022-05-26,13,7480,698,5717,3859,227,0,17981
2022-05-26,14,7482,954,5188,3574,256,0,17454
2022-05-26,15,7481,1320,5265,3449,239,0,17754
2022-05-26,16,7625,1418,5648,3106,160,0,17957
2022-05-26,17,7711,1545,5785,2710,85,0,17836
2022-05-26,18,7707,1546,5888,2316,41,0,17498
2022-05-26,19,7689,1404,5887,1967,14,0,16961
2022-05-26,20,7661,1367,5675,1847,3,0,16553
2022-05-26,21,7654,1017,6203,1915,0,0,16789
2022-05-26,22,7656,927,5532,2221,0,7,16343
2022-05-26,23,7699,559,5057,2380,0,1,15696
2022-05-26,24,7819,371,4731,2286,0,0,15207
2022-05-27,1,8009,371,4399,2072,0,0,14851
2022-05-27,2,8090,371,4420,1871,0,0,14752
2022-05-27,3,8077,378,4297,1914,0,1,14667
2022-05-27,4,8200,410,4823,1443,0,1,14877
2022-05-27,5,8234,593,4434,1308,1,0,14570
2022-05-27,6,8280,848,4240,1261,3,0,14632
2022-05-27,7,8421,1247,4963,1053,15,0,15699
2022-05-27,8,8333,1544,5771,1005,38,0,16691
2022-05-27,9,8296,1635,5939,779,60,0,16709
2022-05-27,10,8442,1798,5353,596,104,0,16293
2022-05-27,11,8440,2038,5482,686,129,0,16775
2022-05-27,12,8439,2051,5243,681,188,0,16602
2022-05-27,13,8443,2046,5441,725,185,0,16840
2022-05-27,14,8441,2021,5262,589,255,1,16569
2022-05-27,15,8452,2001,5379,688,266,0,16786
2022-05-27,16,8471,2020,5980,779,202,0,17452
2022-05-27,17,8584,2068,5838,960,132,0,17582
2022-05-27,18,8590,2054,5742,955,61,0,17402
2022-05-27,19,8593,1864,5902,712,24,0,17095
2022-05-27,20,8595,1809,5673,736,5,0,16818
2022-05-27,21,8703,1485,5451,837,0,3,16479
2022-05-27,22,8737,846,5580,916,0,6,16085
2022-05-27,23,8757,463,5209,808,0,0,15237
2022-05-27,24,8788,368,5221,656,0,0,15033
2022-05-28,1,8788,369,5229,595,0,0,14981
2022-05-28,2,8794,369,4730,849,0,0,14742
2022-05-28,3,8801,370,4655,998,0,0,14824
2022-05-28,4,8812,369,4637,938,0,0,14756
2022-05-28,5,8827,369,4778,847,0,0,14821
2022-05-28,6,8839,369,4794,714,5,0,14721
2022-05-28,7,8832,372,4836,537,49,0,14626
2022-05-28,8,8828,386,5362,398,141,0,15115
2022-05-28,9,8828,374,5394,293,224,0,15113
2022-05-28,10,8834,379,5592,270,258,2,15335
2022-05-28,11,9037,416,5685,309,225,2,15674
2022-05-28,12,9070,792,5628,293,270,0,16053
2022-05-28,13,9075,868,4870,220,319,0,15352
2022-05-28,14,9234,763,4914,310,308,0,15529
2022-05-28,15,9243,731,5203,451,332,0,15960
2022-05-28,16,9277,733,5115,523,313,0,15961
2022-05-28,17,9418,749,5905,490,206,0,16768
2022-05-28,18,9437,745,6130,399,103,0,16814
2022-05-28,19,9441,736,5789,366,32,0,16364
2022-05-28,20,9445,727,5436,382,6,0,15996
2022-05-28,21,9440,722,5623,412,0,0,16197
2022-05-28,22,9435,519,5807,403,0,0,16164
2022-05-28,23,9446,371,5229,393,0,0,15439
2022-05-28,24,9459,371,4804,490,0,0,15124
2022-05-29,1,9463,373,4299,362,0,0,14497
2022-05-29,2,9473,372,4182,672,0,0,14699
2022-05-29,3,9468,370,3998,623,0,0,14459
2022-05-29,4,9511,372,3990,568,1,0,14442
2022-05-29,5,9621,367,3945,417,2,0,14352
2022-05-29,6,9645,368,3950,564,18,0,14545
2022-05-29,7,9649,369,4165,623,65,0,14871
2022-05-29,8,9651,371,4728,447,170,0,15367
2022-05-29,9,9644,377,5348,390,229,1,15989
2022-05-29,10,9642,372,5196,463,276,0,15949
2022-05-29,11,9640,453,5331,634,365,0,16423
2022-05-29,12,9640,522,5327,786,382,0,16657
2022-05-29,13,9641,663,5201,1006,386,0,16897
2022-05-29,14,9635,719,5101,1166,393,0,17014
2022-05-29,15,9627,724,5388,1203,381,0,17323
2022-05-29,16,9620,730,5477,1191,322,0,17340
2022-05-29,17,9630,733,6069,1146,218,0,17796
2022-05-29,18,9637,734,5993,1157,109,0,17630
2022-05-29,19,9628,736,5699,1110,31,0,17204
2022-05-29,20,9644,755,5807,1249,5,1,17461
2022-05-29,21,9666,735,5252,1502,0,1,17156
2022-05-29,22,9669,634,5148,1500,0,0,16951
2022-05-29,23,9666,464,4642,1564,0,0,16336
2022-05-29,24,9671,370,4281,1641,0,0,15963
2022-05-30,1,9673,372,3957,1305,0,0,15307
2022-05-30,2,9666,372,3954,956,0,0,14948
2022-05-30,3,9673,372,3932,775,0,0,14752
2022-05-30,4,9666,372,3942,785,0,0,14765
2022-05-30,5,9673,372,3942,1217,1,0,15205
2022-05-30,6,9681,489,4311,1505,6,0,15992
2022-05-30,7,9682,625,4950,1883,50,0,17190
2022-05-30,8,9674,772,5225,1670,141,0,17482
2022-05-30,9,9660,832,4928,1737,265,0,17422
2022-05-30,10,9661,1113,5038,1650,347,0,17809
2022-05-30,11,9666,1224,5122,1700,394,0,18106
2022-05-30,12,9669,1524,5017,1808,407,0,18425
2022-05-30,13,9666,1844,5070,1835,406,0,18821
2022-05-30,14,9664,1908,5075,2041,389,0,19077
2022-05-30,15,9664,2045,5351,2595,364,0,20019
2022-05-30,16,9648,2310,5307,2515,292,6,20078
2022-05-30,17,9645,2436,6058,2294,195,10,20638
2022-05-30,18,9650,2372,6131,2048,101,10,20312
2022-05-30,19,9654,2495,6225,1927,36,10,20347
2022-05-30,20,9638,2440,6116,1964,6,10,20174
2022-05-30,21,9634,1936,5856,2224,0,10,19660
2022-05-30,22,9642,1575,5260,2155,0,10,18642
2022-05-30,23,9657,671,4753,2478,0,11,17570
2022-05-30,24,9657,374,4304,2343,0,10,16688
2022-05-31,1,9666,375,4003,2548,0,11,16603
2022-05-31,2,9666,372,3869,2570,0,10,16487
2022-05-31,3,9671,373,3848,2166,0,10,16068
2022-05-31,4,9672,384,3878,2027,0,11,15972
2022-05-31,5,9692,385,3856,2217,1,11,16162
2022-05-31,6,9699,591,4287,1755,11,10,16353
2022-05-31,7,9695,1114,5083,1284,58,10,17244
2022-05-31,8,9691,1802,4986,1202,170,10,17861
2022-05-31,9,9689,2229,5250,1335,283,10,18796
2022-05-31,10,9680,2405,5520,1091,338,10,19044
2022-05-31,11,9680,2668,5443,1098,361,10,19260
2022-05-31,12,9667,2730,5469,1637,395,10,19908
2022-05-31,13,9645,2780,5326,2120,329,11,20211
2022-05-31,14,9642,2760,5532,2582,315,21,20852
2022-05-31,15,9638,2763,5498,2608,287,22,20816
2022-05-31,16,9630,2798,5413,2740,268,22,20871
2022-05-31,17,9638,2894,5912,2603,194,22,21263
2022-05-31,18,9646,3093,6005,2158,100,21,21023
2022-05-31,19,9650,3512,5970,1627,32,21,20812
2022-05-31,20,9642,3633,5942,1342,3,21,20583
2022-05-31,21,9641,3738,6012,1098,0,20,20509
2022-05-31,22,9630,3002,5721,1135,0,14,19502
2022-05-31,23,9640,1619,5137,1315,0,10,17721
2022-05-31,24,9655,786,4595,1597,0,10,16643
2022-06-01,1,9661,462,4549,1867,0,10,16549
2022-06-01,2,9658,370,4407,2048,0,10,16493
2022-06-01,3,9649,377,4555,2018,0,10,16609
2022-06-01,4,9651,490,4811,1937,0,10,16899
2022-06-01,5,9654,699,4891,1864,0,10,17118
2022-06-01,6,9665,982,4488,1968,3,10,17116
2022-06-01,7,9657,1130,5322,1862,32,10,18013
2022-06-01,8,9657,1282,5915,1515,85,10,18464
2022-06-01,9,9649,1652,5967,1191,127,10,18596
2022-06-01,10,9644,2078,5405,1053,174,10,18364
2022-06-01,11,9642,2423,5311,845,210,10,18441
2022-06-01,12,9642,2382,5432,1341,169,10,18976
2022-06-01,13,9638,2292,5085,1607,80,11,18713
2022-06-01,14,9625,2243,5256,1298,168,11,18601
2022-06-01,15,9613,2244,5227,1613,116,17,18830
2022-06-01,16,9619,2246,5417,1699,85,23,19089
2022-06-01,17,9630,2242,5494,1328,130,23,18847
2022-06-01,18,9637,2248,5672,1097,52,23,18729
2022-06-01,19,9636,2249,5445,1022,21,23,18396
2022-06-01,20,9636,1666,5616,946,5,23,17892
2022-06-01,21,9645,1402,5797,1009,0,24,17877
2022-06-01,22,9659,1051,5725,1049,0,16,17500
2022-06-01,23,9657,540,5157,1215,0,11,16580
2022-06-01,24,9657,373,4823,1182,0,11,16046
2022-06-02,1,9656,374,4298,944,0,11,15283
2022-06-02,2,9658,394,4237,1042,0,11,15342
2022-06-02,3,9666,401,4272,798,0,11,15148
2022-06-02,4,9661,410,4181,734,1,11,14998
2022-06-02,5,9658,668,4156,591,2,11,15086
2022-06-02,6,9653,792,4445,681,15,11,15597
2022-06-02,7,9660,932,4980,471,57,11,16111
2022-06-02,8,9650,948,5521,239,131,11,16500
2022-06-02,9,9652,1087,5646,159,172,10,16726
2022-06-02,10,9649,1228,5611,191,194,10,16883
2022-06-02,11,9649,1223,5701,252,233,10,17068
2022-06-02,12,9646,1249,5552,312,211,10,16980
2022-06-02,13,9643,1246,5555,337,209,10,17000
2022-06-02,14,9626,1249,5525,301,239,10,16950
2022-06-02,15,9630,1252,5465,240,212,19,16818
2022-06-02,16,9627,1252,5240,290,195,23,16627
2022-06-02,17,9623,1308,5292,319,177,23,16742
2022-06-02,18,9626,1444,5307,204,96,23,16700
2022-06-02,19,9628,1098,5870,381,33,23,17033
2022-06-02,20,9636,1114,6208,316,7,23,17304
2022-06-02,21,9646,1060,6111,436,0,23,17276
2022-06-02,22,9646,573,5913,471,0,16,16619
2022-06-02,23,9648,389,5542,514,0,10,16103
2022-06-02,24,9638,375,4868,628,0,10,15519
2022-06-03,1,9646,373,4149,693,0,10,14871
2022-06-03,2,9647,371,4096,618,0,10,14742
2022-06-03,3,9649,372,4025,509,0,10,14565
2022-06-03,4,9659,371,4098,404,0,10,14542
2022-06-03,5,9658,372,4345,366,1,10,14752
2022-06-03,6,9645,370,4558,300,12,10,14895
2022-06-03,7,9640,371,5181,327,70,10,15599
2022-06-03,8,9639,372,5603,142,173,10,15939
2022-06-03,9,9618,380,5753,125,282,10,16168
2022-06-03,10,9615,373,5510,287,345,10,16140
2022-06-03,11,9593,483,5468,599,355,10,16508
2022-06-03,12,9440,597,5260,634,319,10,16260
2022-06-03,13,9534,714,5422,1044,237,11,16962
2022-06-03,14,9599,717,5300,1753,239,11,17619
2022-06-03,15,9603,717,5198,1905,205,17,17645
2022-06-03,16,9615,721,5317,1849,181,23,17706
2022-06-03,17,9627,730,5304,1931,147,24,17763
2022-06-03,18,9628,729,5319,1511,90,24,17301
2022-06-03,19,9631,736,5119,1830,28,24,17368
2022-06-03,20,9629,719,5088,1960,6,24,17426
2022-06-03,21,9632,512,5054,2398,0,23,17619
2022-06-03,22,9626,369,4662,2314,0,13,16984
2022-06-03,23,9630,368,3967,2209,0,11,16185
2022-06-03,24,9631,368,3878,1266,0,10,15153
2022-06-04,1,9637,209,3812,817,0,1,14476
2022-06-04,2,9640,131,3796,554,0,0,14121
2022-06-04,3,9417,132,3810,353,0,0,13712
2022-06-04,4,9354,131,3806,608,0,0,13899
2022-06-04,5,9357,130,3849,495,1,0,13832
2022-06-04,6,9343,131,4014,523,13,0,14024
2022-06-04,7,9384,131,4504,472,69,0,14560
2022-06-04,8,9614,131,4419,423,186,0,14773
2022-06-04,9,9622,132,4482,504,306,0,15046
2022-06-04,10,9647,131,4343,617,379,0,15117
2022-06-04,11,9647,132,4568,802,402,0,15551
2022-06-04,12,9635,134,4405,1039,403,0,15616
2022-06-04,13,9628,247,4241,960,386,0,15462
2022-06-04,14,9625,359,4149,868,373,0,15374
2022-06-04,15,9626,483,4216,760,382,0,15467
2022-06-04,16,9623,483,4562,915,327,0,15910
2022-06-04,17,9621,487,4973,1166,233,0,16480
2022-06-04,18,9627,489,4994,1129,116,0,16355
2022-06-04,19,9629,484,5106,945,31,0,16195
2022-06-04,20,9611,483,5156,668,8,0,15926
2022-06-04,21,9616,416,5140,680,0,0,15852
2022-06-04,22,9621,376,5215,714,0,0,15926
2022-06-04,23,9630,240,4752,866,0,0,15488
2022-06-04,24,9637,141,4064,746,0,0,14588
2022-06-05,1,9643,141,3883,433,0,0,14100
2022-06-05,2,9405,140,3869,313,0,0,13727
2022-06-05,3,9112,138,3811,361,0,0,13422
2022-06-05,4,8810,140,3903,501,1,0,13355
2022-06-05,5,8743,137,3885,592,3,0,13360
2022-06-05,6,8754,136,3946,550,15,0,13401
2022-06-05,7,8752,137,4240,549,66,0,13744
2022-06-05,8,8753,137,4798,389,177,0,14254
2022-06-05,9,9152,137,4679,521,277,0,14766
2022-06-05,10,9462,138,4558,521,368,0,15047
2022-06-05,11,9627,138,4732,449,386,0,15332
2022-06-05,12,9618,234,5112,495,360,0,15819
2022-06-05,13,9624,431,5237,438,314,0,16044
2022-06-05,14,9617,688,4974,389,319,0,15987
2022-06-05,15,9614,686,4480,471,262,0,15513
2022-06-05,16,9611,482,4693,789,199,0,15774
2022-06-05,17,9609,484,4895,828,147,0,15963
2022-06-05,18,9611,485,5073,914,72,0,16155
2022-06-05,19,9614,484,5067,1020,27,0,16212
2022-06-05,20,9614,484,5007,741,5,0,15851
2022-06-05,21,9611,288,5464,1110,0,0,16473
2022-06-05,22,9621,134,4932,1253,0,6,15946
2022-06-05,23,9619,133,4508,1310,0,11,15581
2022-06-05,24,9617,133,3979,994,0,11,14734
2022-06-06,1,9624,131,3889,750,0,14,14408
2022-06-06,2,9631,131,3844,633,0,11,14250
2022-06-06,3,9569,131,3835,310,0,11,13856
2022-06-06,4,9341,131,3891,540,0,11,13914
2022-06-06,5,9339,131,3945,1051,2,11,14479
2022-06-06,6,9554,232,4043,1450,10,11,15300
2022-06-06,7,9627,350,4579,1617,49,11,16233
2022-06-06,8,9614,474,4766,1547,102,11,16514
2022-06-06,9,9627,477,4923,1467,146,11,16651
2022-06-06,10,9624,478,5602,1363,158,11,17236
2022-06-06,11,9630,480,5594,1491,210,11,17416
2022-06-06,12,9629,480,5134,1710,199,11,17163
2022-06-06,13,9632,480,5068,1824,225,9,17238
2022-06-06,14,9630,500,5118,1712,238,13,17211
2022-06-06,15,9622,529,5549,1335,143,13,17191
2022-06-06,16,9638,617,5817,1106,99,16,17293
2022-06-06,17,9636,719,5627,1090,83,37,17192
2022-06-06,18,9640,697,5110,1265,41,37,16790
2022-06-06,19,9641,697,4910,1296,12,34,16590
2022-06-06,20,9643,479,5000,1235,0,27,16384
2022-06-06,21,9637,166,5175,1804,0,25,16807
2022-06-06,22,9633,134,4791,1846,0,16,16420
2022-06-06,23,9635,136,4239,1962,0,11,15983
2022-06-06,24,9640,135,3866,1640,0,11,15292
2022-06-07,1,9631,137,3758,1251,0,11,14788
2022-06-07,2,9636,142,3734,1030,0,11,14553
2022-06-07,3,9649,159,3728,767,0,11,14314
2022-06-07,4,9652,164,3710,903,0,11,14440
2022-06-07,5,9647,232,3739,1104,0,11,14733
2022-06-07,6,9646,320,3866,1515,6,11,15364
2022-06-07,7,9642,415,4585,1498,26,11,16177
2022-06-07,8,9638,439,4903,1887,40,11,16918
2022-06-07,9,9634,449,5018,1719,53,11,16884
2022-06-07,10,9626,488,5442,1880,62,11,17509
2022-06-07,11,9617,512,5369,2003,78,11,17590
2022-06-07,12,9630,512,5286,1917,94,11,17450
2022-06-07,13,9622,588,4964,1709,82,11,16976
2022-06-07,14,9620,573,5230,1610,104,11,17148
2022-06-07,15,9623,594,5198,1461,98,18,16992
2022-06-07,16,9637,630,5010,1313,144,23,16757
2022-06-07,17,9631,632,5096,1426,117,23,16925
2022-06-07,18,9641,632,5260,1214,68,23,16838
2022-06-07,19,9641,645,5473,951,28,23,16761
2022-06-07,20,9632,799,5854,663,8,23,16979
2022-06-07,21,9633,659,5641,624,0,23,16580
2022-06-07,22,9643,297,5086,626,0,17,15669
2022-06-07,23,9659,139,4465,615,0,11,14889
2022-06-07,24,9667,160,4133,678,0,11,14649
2022-06-08,1,9668,164,4323,702,0,11,14868
2022-06-08,2,9670,164,3915,697,0,11,14457
2022-06-08,3,9672,229,3940,606,0,11,14458
2022-06-08,4,9674,318,3728,613,0,11,14344
2022-06-08,5,9673,400,4149,502,2,11,14737
2022-06-08,6,9674,405,4401,346,9,11,14846
2022-06-08,7,9671,424,5077,218,67,11,15468
2022-06-08,8,9668,496,5485,108,187,11,15955
2022-06-08,9,9664,648,5466,87,305,11,16181
2022-06-08,10,9661,623,5241,84,348,10,15967
2022-06-08,11,9666,511,5053,171,353,10,15764
2022-06-08,12,9655,429,4996,427,342,11,15860
2022-06-08,13,9648,336,5142,360,330,11,15827
2022-06-08,14,9654,376,5163,239,316,11,15759
2022-06-08,15,9664,455,5312,285,284,20,16020
2022-06-08,16,9664,477,5553,276,213,23,16206
2022-06-08,17,9670,486,5561,320,141,23,16201
2022-06-08,18,9681,502,5181,314,71,23,15772
2022-06-08,19,9683,627,5012,227,23,23,15595
2022-06-08,20,9687,613,5645,323,4,23,16295
2022-06-08,21,9687,601,5414,478,0,23,16203
2022-06-08,22,9700,419,5183,613,0,16,15931
2022-06-08,23,9713,173,4511,751,0,10,15158
2022-06-08,24,9716,143,4080,843,0,10,14792
2022-06-09,1,9716,143,3920,743,0,10,14532
2022-06-09,2,9713,142,3880,792,0,10,14537
2022-06-09,3,9700,141,3645,910,0,10,14406
2022-06-09,4,9705,144,3657,842,0,10,14358
2022-06-09,5,9705,141,3729,977,1,10,14563
2022-06-09,6,9701,141,3874,841,3,10,14570
2022-06-09,7,9695,141,4462,521,25,11,14855
2022-06-09,8,9696,141,4547,579,58,22,15043
2022-06-09,9,9688,161,4319,849,126,17,15160
2022-06-09,10,9684,165,4380,703,161,11,15104
2022-06-09,11,9694,167,4413,793,230,11,15308
2022-06-09,12,9693,169,4347,613,272,11,15105
2022-06-09,13,9693,255,4415,1166,273,11,15813
2022-06-09,14,9697,280,4314,991,238,11,15531
2022-06-09,15,9697,302,4240,1123,238,21,15621
2022-06-09,16,9699,361,4246,1385,237,20,15948
2022-06-09,17,9701,366,4409,1675,196,21,16368
2022-06-09,18,9698,377,4697,1686,110,23,16591
2022-06-09,19,9699,696,5143,1544,30,22,17134
2022-06-09,20,9691,662,5498,1434,3,23,17311
2022-06-09,21,9679,710,5881,790,0,22,17082
2022-06-09,22,9673,576,5522,669,0,16,16456
2022-06-09,23,9673,146,4374,676,0,10,14879
2022-06-09,24,9668,131,3820,546,0,10,14175
2022-06-10,1,9671,132,3717,680,0,10,14210
2022-06-10,2,9675,132,3567,963,0,10,14347
2022-06-10,3,9674,133,3467,918,0,10,14202
2022-06-10,4,9688,133,3509,903,1,10,14244
2022-06-10,5,9687,232,3655,1007,1,10,14592
2022-06-10,6,9682,357,3857,749,10,10,14665
2022-06-10,7,9676,503,4909,509,61,10,15668
2022-06-10,8,9672,519,5552,332,153,10,16238
2022-06-10,9,9674,530,5506,263,253,10,16236
2022-06-10,10,9624,562,5436,299,314,10,16245
2022-06-10,11,9616,632,4928,393,379,10,15958
2022-06-10,12,9677,686,4997,527,357,10,16254
2022-06-10,13,9681,526,4841,497,378,10,15933
2022-06-10,14,9519,439,5046,869,351,10,16234
2022-06-10,15,9494,647,5093,861,341,19,16455
2022-06-10,16,9670,718,5213,662,305,23,16591
2022-06-10,17,9678,787,5337,1084,226,23,17135
2022-06-10,18,9675,631,5475,838,113,24,16756
2022-06-10,19,9670,576,5606,913,28,23,16816
2022-06-10,20,9672,395,5311,1004,6,24,16412
2022-06-10,21,9667,359,5322,951,1,23,16323
2022-06-10,22,9663,359,5297,869,0,10,16198
2022-06-10,23,9652,224,4777,766,0,11,15430
2022-06-10,24,9648,131,4118,612,0,11,14520
2022-06-11,1,9642,131,3837,546,0,1,14157
2022-06-11,2,9646,131,3654,563,0,0,13994
2022-06-11,3,9647,131,3616,340,0,0,13734
2022-06-11,4,9645,131,3568,269,1,0,13614
2022-06-11,5,9650,131,3689,446,3,0,13919
2022-06-11,6,9651,131,3688,587,14,0,14071
2022-06-11,7,9650,130,4349,255,63,0,14447
2022-06-11,8,9644,131,5032,395,156,0,15358
2022-06-11,9,9637,130,5432,328,271,0,15798
2022-06-11,10,9642,130,5093,311,357,0,15533
2022-06-11,11,9652,130,5162,375,394,0,15713
2022-06-11,12,9636,131,5461,537,381,0,16146
2022-06-11,13,9632,219,5141,833,351,0,16176
2022-06-11,14,9630,286,4965,1000,373,0,16254
2022-06-11,15,9633,357,4801,1034,368,0,16193
2022-06-11,16,9637,357,4862,1256,278,0,16390
2022-06-11,17,9644,358,5014,1449,194,0,16659
2022-06-11,18,9645,359,5249,1307,105,0,16665
2022-06-11,19,9640,360,5590,1227,30,0,16847
2022-06-11,20,9641,361,5612,1233,5,0,16852
2022-06-11,21,9636,360,5828,1103,0,0,16927
2022-06-11,22,9636,222,5539,1005,0,0,16402
2022-06-11,23,9637,130,4719,1190,0,0,15676
2022-06-11,24,9636,130,4052,1135,0,0,14953
2022-06-12,1,9631,130,3869,781,0,0,14411
2022-06-12,2,9631,130,3727,500,0,0,13988
2022-06-12,3,9634,130,3676,420,0,0,13860
2022-06-12,4,9635,130,3626,379,0,0,13770
2022-06-12,5,9396,130,3641,294,2,0,13463
2022-06-12,6,9344,129,3550,704,6,0,13733
2022-06-12,7,9346,130,3730,776,39,0,14021
2022-06-12,8,9595,130,4052,981,63,0,14821
2022-06-12,9,9619,130,4855,720,116,0,15440
2022-06-12,10,9619,131,5185,694,202,0,15831
2022-06-12,11,9624,131,5354,772,217,0,16098
2022-06-12,12,9615,131,5495,669,273,0,16183
2022-06-12,13,9617,218,5371,792,268,0,16266
2022-06-12,14,9617,285,5151,938,198,0,16189
2022-06-12,15,9622,353,5234,933,172,0,16314
2022-06-12,16,9613,354,5490,851,200,0,16508
2022-06-12,17,9608,365,5865,736,107,0,16681
2022-06-12,18,9611,359,5840,707,67,0,16584
2022-06-12,19,9606,358,5427,729,36,0,16156
2022-06-12,20,9597,357,5591,696,8,0,16249
2022-06-12,21,9608,353,5612,656,1,3,16233
2022-06-12,22,9615,214,5701,644,0,10,16184
2022-06-12,23,9621,127,5252,679,0,10,15689
2022-06-12,24,9616,130,4448,469,0,11,14674
2022-06-13,1,9622,130,3924,401,0,11,14088
2022-06-13,2,9620,142,3874,267,0,11,13914
2022-06-13,3,9380,189,3918,237,0,11,13735
2022-06-13,4,9337,242,3993,220,1,11,13804
2022-06-13,5,9337,403,4125,233,2,11,14111
2022-06-13,6,9337,700,4580,225,15,11,14868
2022-06-13,7,9485,1111,4607,229,71,11,15514
2022-06-13,8,9623,1175,4709,92,176,11,15786
2022-06-13,9,9625,1327,4683,53,274,11,15973
2022-06-13,10,9621,1606,4653,46,190,11,16127
2022-06-13,11,9622,1668,4483,68,366,10,16217
2022-06-13,12,9604,1783,4475,94,363,11,16330
2022-06-13,13,9587,1953,4496,56,63,11,16166
2022-06-13,14,9580,1620,4527,122,274,11,16134
2022-06-13,15,9586,1602,4547,300,315,19,16369
2022-06-13,16,9585,1740,4830,392,227,23,16797
2022-06-13,17,9581,1916,5052,274,155,23,17001
2022-06-13,18,9592,1904,5185,282,106,23,17092
2022-06-13,19,9607,1881,5262,353,38,23,17164
2022-06-13,20,9618,1660,4831,705,9,23,16846
2022-06-13,21,9620,1180,5213,766,1,23,16803
2022-06-13,22,9624,868,4476,989,1,15,15973
2022-06-13,23,9625,319,4325,1162,1,11,15443
2022-06-13,24,9620,150,4562,775,1,10,15118
2022-06-14,1,9624,143,4486,978,1,11,15243
2022-06-14,2,9617,135,3829,1224,1,11,14817
2022-06-14,3,9621,150,3744,1093,0,12,14620
2022-06-14,4,9624,159,4042,754,1,12,14592
2022-06-14,5,9624,269,4105,823,1,10,14832
2022-06-14,6,9625,648,4057,570,11,10,14921
2022-06-14,7,9619,1134,4543,327,67,10,15700
2022-06-14,8,9609,1305,4769,419,184,10,16296
2022-06-14,9,9599,1375,4869,356,287,11,16497
2022-06-14,10,9598,1538,4859,347,361,11,16714
2022-06-14,11,9596,1857,4529,457,393,14,16846
2022-06-14,12,9584,2208,4559,519,383,13,17266
2022-06-14,13,9584,2211,4471,223,326,10,16825
2022-06-14,14,9592,2261,4691,386,366,12,17308
2022-06-14,15,9596,2360,4628,485,314,21,17404
2022-06-14,16,9601,2424,4833,749,308,23,17938
2022-06-14,17,9590,3077,5068,788,218,23,18764
2022-06-14,18,9591,3388,4982,618,119,23,18721
2022-06-14,19,9594,3022,5295,621,33,23,18588
2022-06-14,20,9600,2387,5159,907,7,23,18083
2022-06-14,21,9597,2129,4691,1300,0,22,17739
2022-06-14,22,9594,1477,4304,1286,0,16,16677
2022-06-14,23,9570,492,4180,1613,0,11,15866
2022-06-14,24,9568,222,3993,1454,0,11,15248
2022-06-15,1,9566,187,3784,1398,0,10,14945
2022-06-15,2,9565,146,3513,1721,0,11,14956
2022-06-15,3,9585,170,3509,1634,0,11,14909
2022-06-15,4,9594,216,3482,1619,0,10,14921
2022-06-15,5,9605,564,3515,1302,2,10,14998
2022-06-15,6,9617,896,3820,1184,8,10,15535
2022-06-15,7,9621,1292,4080,1327,39,10,16369
2022-06-15,8,9624,1553,4626,1204,139,9,17155
2022-06-15,9,9622,1871,4748,788,218,9,17256
2022-06-15,10,9619,2000,4513,751,237,9,17129
2022-06-15,11,9613,2287,4638,609,229,9,17385
2022-06-15,12,9607,2420,4511,645,236,10,17429
2022-06-15,13,9604,2694,4652,779,296,9,18034
2022-06-15,14,9612,2440,4638,924,377,11,18002
2022-06-15,15,9596,2438,4790,1093,364,13,18294
2022-06-15,16,9602,2574,4922,1939,287,22,19346
2022-06-15,17,9611,2676,4898,2220,169,23,19597
2022-06-15,18,9606,2618,4969,2180,99,23,19495
2022-06-15,19,9609,2638,5283,2139,37,23,19729
2022-06-15,20,9599,2352,5158,2218,7,23,19357
2022-06-15,21,9590,1909,5168,2274,0,23,18964
2022-06-15,22,9594,1420,4868,2246,0,23,18151
2022-06-15,23,9592,1276,4241,2218,0,15,17342
2022-06-15,24,9613,669,3724,2251,0,11,16268
2022-06-16,1,9605,320,3769,2402,0,11,16107
2022-06-16,2,9607,163,3953,2371,0,11,16105
2022-06-16,3,9613,167,3625,2542,0,11,15958
2022-06-16,4,9611,208,3413,2676,1,11,15920
2022-06-16,5,9619,332,3518,2391,1,11,15872
2022-06-16,6,9626,519,3845,2190,4,11,16195
2022-06-16,7,9626,791,4658,2319,47,11,17452
2022-06-16,8,9625,1233,4835,2455,123,11,18282
2022-06-16,9,9632,1685,4844,2375,218,11,18765
2022-06-16,10,9631,1978,4758,2295,329,11,19002
2022-06-16,11,9622,2260,4942,2999,307,10,20140
2022-06-16,12,9619,2419,4935,3011,367,10,20361
2022-06-16,13,9625,2480,5030,3069,386,11,20601
2022-06-16,14,9627,2490,4541,3103,362,12,20135
2022-06-16,15,9612,2407,4809,3372,271,21,20492
2022-06-16,16,9619,2611,5147,3016,174,31,20598
2022-06-16,17,9627,2946,5228,2727,133,31,20692
2022-06-16,18,9640,2640,4794,2708,107,29,19918
2022-06-16,19,9639,2595,5105,2826,38,29,20232
2022-06-16,20,9638,2220,5565,2721,9,29,20182
2022-06-16,21,9630,2026,5158,3061,0,26,19901
2022-06-16,22,9630,1515,4477,3094,0,23,18739
2022-06-16,23,9631,909,4162,3087,0,14,17803
2022-06-16,24,9630,358,4163,2950,0,11,17112
2022-06-17,1,9629,160,4260,2626,0,11,16686
2022-06-17,2,9634,160,4104,2555,0,11,16464
2022-06-17,3,9644,160,4109,2460,0,11,16384
2022-06-17,4,9652,164,3754,2526,0,11,16107
2022-06-17,5,9655,280,3626,2603,2,10,16176
2022-06-17,6,9658,436,3991,2327,7,11,16430
2022-06-17,7,9654,597,4475,2545,50,11,17332
2022-06-17,8,9647,636,4787,2999,148,10,18227
2022-06-17,9,9649,630,4447,3143,246,10,18125
2022-06-17,10,9638,654,4352,3145,314,11,18114
2022-06-17,11,9640,597,4258,3286,322,13,18116
2022-06-17,12,9648,582,4457,3499,309,11,18506
2022-06-17,13,9658,596,4401,3711,375,11,18752
2022-06-17,14,9660,626,4417,3837,358,11,18909
2022-06-17,15,9652,688,4850,3964,332,19,19505
2022-06-17,16,9662,806,4894,3979,286,24,19651
2022-06-17,17,9665,808,5063,3820,205,23,19584
2022-06-17,18,9667,805,5102,3813,106,23,19516
2022-06-17,19,9672,806,4965,3607,30,23,19103
2022-06-17,20,9676,613,5005,3560,5,23,18882
2022-06-17,21,9676,426,4769,3671,0,23,18565
2022-06-17,22,9672,257,4564,3769,0,15,18277
2022-06-17,23,9674,140,3727,3338,0,10,16889
2022-06-17,24,9674,137,3609,2389,0,7,15816
2022-06-18,1,9686,138,3622,1493,0,0,14939
2022-06-18,2,9694,137,3554,1111,0,0,14496
2022-06-18,3,9694,137,3544,994,0,0,14369
2022-06-18,4,9703,138,3481,895,0,0,14217
2022-06-18,5,9708,138,3505,971,1,0,14323
2022-06-18,6,9724,138,3534,1095,11,0,14502
2022-06-18,7,9722,137,3599,1403,54,0,14915
2022-06-18,8,9720,137,3568,1982,158,0,15565
2022-06-18,9,9720,137,3598,2135,270,0,15860
2022-06-18,10,9717,136,3620,2185,367,0,16025
2022-06-18,11,9716,136,3664,2129,410,0,16055
2022-06-18,12,9710,134,3707,1949,424,0,15924
2022-06-18,13,9720,136,3813,1564,421,0,15654
2022-06-18,14,9723,137,3788,1333,426,0,15407
2022-06-18,15,9718,135,3748,1231,420,0,15252
2022-06-18,16,9713,138,3790,1703,373,0,15717
2022-06-18,17,9711,136,3968,2235,270,0,16320
2022-06-18,18,9715,137,4240,2635,139,0,16866
2022-06-18,19,9725,137,4471,2732,34,0,17099
2022-06-18,20,9717,135,4801,2234,7,0,16894
2022-06-18,21,9711,136,4956,2118,1,0,16922
2022-06-18,22,9716,138,4322,1999,0,0,16175
2022-06-18,23,9726,138,3864,1819,0,0,15547
2022-06-18,24,9728,138,3580,1417,0,0,14863
2022-06-19,1,9727,138,3495,1189,0,0,14549
2022-06-19,2,9677,137,3471,373,0,0,13658
2022-06-19,3,9437,137,3476,555,0,0,13605
2022-06-19,4,9127,137,3498,758,0,0,13520
2022-06-19,5,8837,136,3472,982,2,0,13429
2022-06-19,6,8847,136,3476,445,14,0,12918
2022-06-19,7,8865,134,4288,690,72,0,14049
2022-06-19,8,9287,133,4664,405,188,0,14677
2022-06-19,9,9713,133,4483,324,301,0,14954
2022-06-19,10,9729,134,4507,324,371,0,15065
2022-06-19,11,9730,221,4221,445,400,0,15017
2022-06-19,12,9731,245,3930,636,415,0,14957
2022-06-19,13,9732,294,4119,654,412,0,15211
2022-06-19,14,9733,355,4197,623,406,0,15314
2022-06-19,15,9732,360,4429,860,376,0,15757
2022-06-19,16,9734,363,4643,770,321,0,15831
2022-06-19,17,9737,363,5014,631,179,0,15924
2022-06-19,18,9737,364,4956,399,97,0,15553
2022-06-19,19,9730,367,5185,358,33,0,15673
2022-06-19,20,9728,384,5542,349,6,0,16009
2022-06-19,21,9732,257,5674,344,1,1,16009
2022-06-19,22,9729,214,5572,396,0,13,15924
2022-06-19,23,9724,160,4774,547,0,12,15217
2022-06-19,24,9730,163,4414,551,0,11,14869
2022-06-20,1,9736,164,4229,507,0,12,14648
2022-06-20,2,9734,165,3843,586,0,11,14339
2022-06-20,3,9730,165,3673,636,0,11,14215
2022-06-20,4,9733,166,3913,647,0,11,14470
2022-06-20,5,9736,262,3968,647,0,11,14624
2022-06-20,6,9734,385,3991,687,8,14,14819
2022-06-20,7,9734,511,4358,656,46,11,15316
2022-06-20,8,9734,519,4573,692,133,10,15661
2022-06-20,9,9729,579,4870,649,235,11,16073
2022-06-20,10,9729,613,4975,841,309,12,16479
2022-06-20,11,9723,681,5167,894,332,12,16809
2022-06-20,12,9720,766,4660,1076,316,10,16548
2022-06-20,13,9724,692,4290,1157,288,10,16161
2022-06-20,14,9724,764,4537,1192,234,11,16462
2022-06-20,15,9723,1044,4239,1281,231,17,16535
2022-06-20,16,9726,1108,4119,1423,211,24,16611
2022-06-20,17,9724,1187,4437,1392,187,24,16951
2022-06-20,18,9729,1192,4795,1181,112,25,17034
2022-06-20,19,9728,1193,4979,1222,37,24,17183
2022-06-20,20,9726,1193,5352,1223,9,25,17528
2022-06-20,21,9726,564,5271,1507,0,23,17091
2022-06-20,22,9717,388,4414,1864,0,15,16398
2022-06-20,23,9716,252,3829,1970,0,11,15778
2022-06-20,24,9717,162,3481,2000,0,12,15372
2022-06-21,1,9725,165,3422,2034,0,15,15361
2022-06-21,2,9728,168,3509,2086,0,11,15502
2022-06-21,3,9727,196,3489,1891,0,11,15314
2022-06-21,4,9722,198,3378,2021,0,11,15330
2022-06-21,5,9723,239,3383,1775,1,11,15132
2022-06-21,6,9725,397,3502,1465,6,11,15106
2022-06-21,7,9726,596,4206,1417,51,11,16007
2022-06-21,8,9725,1202,4809,1276,140,11,17163
2022-06-21,9,9719,1470,4824,1078,199,11,17301
2022-06-21,10,9720,2069,4886,921,236,11,17843
2022-06-21,11,9720,2516,4989,777,292,11,18305
2022-06-21,12,9717,2688,4924,943,306,11,18589
2022-06-21,13,9712,2576,4436,1577,346,11,18658
2022-06-21,14,9703,2981,4448,2283,330,12,19757
2022-06-21,15,9703,3129,4751,2472,330,18,20403
2022-06-21,16,9696,3350,5133,2535,328,25,21067
2022-06-21,17,9698,4082,5298,2194,224,33,21529
2022-06-21,18,9699,3939,5307,1770,113,36,20864
2022-06-21,19,9697,4013,5417,1500,39,34,20700
2022-06-21,20,9706,3724,5362,1470,8,24,20294
2022-06-21,21,9696,3747,5299,1571,1,24,20338
2022-06-21,22,9703,3107,4987,1829,0,13,19639
2022-06-21,23,9703,1436,4550,2211,0,11,17911
2022-06-21,24,9707,663,4150,2296,0,11,16827
2022-06-22,1,9709,259,4085,2487,0,11,16551
2022-06-22,2,9706,171,4168,2448,0,11,16504
2022-06-22,3,9702,211,4503,2225,0,11,16652
2022-06-22,4,9705,443,4545,1880,1,11,16585
2022-06-22,5,9704,1058,3890,1834,1,11,16498
2022-06-22,6,9702,1642,4019,1497,9,11,16880
2022-06-22,7,9698,2356,4449,1204,54,11,17772
2022-06-22,8,9695,2990,5204,985,144,12,19030
2022-06-22,9,9687,3321,5164,952,253,11,19388
2022-06-22,10,9685,2983,5214,1146,341,12,19381
2022-06-22,11,9690,3493,5233,1138,352,18,19924
2022-06-22,12,9687,3632,5402,1255,347,31,20354
2022-06-22,13,9680,3888,5452,1361,341,33,20755
2022-06-22,14,9679,4236,5536,1419,370,32,21272
2022-06-22,15,9673,4130,5525,1362,372,39,21101
2022-06-22,16,9680,4151,5560,1426,308,40,21165
2022-06-22,17,9314,4419,5572,1675,234,37,21251
2022-06-22,18,8792,4720,5607,1996,131,33,21279
2022-06-22,19,8797,4270,5642,2125,40,30,20904
2022-06-22,20,8803,4287,5399,1897,8,26,20420
2022-06-22,21,8807,4147,5328,2004,0,24,20310
2022-06-22,22,8804,3178,5311,2026,0,17,19336
2022-06-22,23,8808,1889,4631,2126,0,12,17466
2022-06-22,24,8805,579,4342,2248,0,11,15985
2022-06-23,1,8811,192,4144,2158,0,11,15316
2022-06-23,2,8817,166,4335,2057,0,11,15386
2022-06-23,3,8818,159,4407,1893,0,11,15288
2022-06-23,4,8819,163,4457,1716,0,11,15166
2022-06-23,5,8821,268,4114,1583,2,12,14800
2022-06-23,6,8821,751,3879,1272,8,11,14742
2022-06-23,7,8823,1809,4249,1095,53,11,16040
2022-06-23,8,8822,2524,4122,822,172,11,16473
2022-06-23,9,8816,2899,4521,506,278,11,17031
2022-06-23,10,8817,3154,4481,462,344,10,17268
2022-06-23,11,8811,3514,4436,669,349,11,17790
2022-06-23,12,8820,3521,4599,836,380,10,18166
2022-06-23,13,8818,3276,4538,1140,364,11,18147
2022-06-23,14,8818,3289,4660,1148,393,12,18320
2022-06-23,15,8804,3465,4770,1154,358,20,18571
2022-06-23,16,8801,4306,4776,1069,314,23,19289
2022-06-23,17,8801,4655,5181,954,214,24,19829
2022-06-23,18,8813,4479,5472,773,113,23,19673
2022-06-23,19,8812,4778,5442,580,37,24,19673
2022-06-23,20,8810,4556,5122,489,8,24,19009
2022-06-23,21,8809,3900,5047,462,0,24,18242
2022-06-23,22,8814,3394,4695,458,0,18,17379
2022-06-23,23,8817,2017,4471,473,0,11,15789
2022-06-23,24,8827,1237,4413,479,0,11,14967
2022-06-24,1,8822,834,4431,359,0,11,14457
2022-06-24,2,8822,941,4314,245,0,11,14333
2022-06-24,3,8827,1021,4405,132,0,11,14396
2022-06-24,4,8830,1028,4351,54,0,11,14274
2022-06-24,5,8829,1000,4182,57,1,11,14080
2022-06-24,6,8831,1301,3928,83,8,11,14162
2022-06-24,7,8826,1960,4209,57,48,11,15111
2022-06-24,8,8820,2424,4532,55,166,11,16008
2022-06-24,9,8823,2713,4784,48,271,11,16650
2022-06-24,10,8817,2697,4870,178,348,12,16922
2022-06-24,11,8810,3091,4741,260,385,11,17298
2022-06-24,12,8809,3336,4715,397,399,12,17668
2022-06-24,13,8799,3585,4608,493,397,10,17892
2022-06-24,14,8788,3933,4801,567,403,11,18503
2022-06-24,15,8787,4061,4985,608,375,17,18833
2022-06-24,16,8782,4633,5024,481,314,41,19275
2022-06-24,17,8784,5195,5342,367,238,77,20003
2022-06-24,18,8797,5077,5610,329,122,131,20066
2022-06-24,19,8806,5236,5559,291,37,160,20089
2022-06-24,20,8809,5028,5280,372,8,168,19665
2022-06-24,21,8805,4108,5154,548,1,119,18735
2022-06-24,22,8807,3854,4479,701,0,84,17925
2022-06-24,23,8816,2676,4315,747,0,74,16628
2022-06-24,24,8823,1732,3968,759,0,19,15301
2022-06-25,1,8820,990,4058,772,0,0,14640
2022-06-25,2,8826,890,3981,675,0,0,14372
2022-06-25,3,8831,1094,3928,612,0,0,14465
2022-06-25,4,8830,1157,3863,594,0,0,14444
2022-06-25,5,8834,1094,3851,539,2,0,14320
2022-06-25,6,8826,1360,3663,449,8,0,14306
2022-06-25,7,8812,1452,4008,358,59,0,14689
2022-06-25,8,8810,1758,4320,185,169,0,15242
2022-06-25,9,8805,2481,4471,153,280,0,16190
2022-06-25,10,8807,3107,4362,209,354,0,16839
2022-06-25,11,8809,3797,4458,185,396,0,17645
2022-06-25,12,8815,4260,4481,253,414,0,18223
2022-06-25,13,8820,4288,4340,365,416,12,18241
2022-06-25,14,8821,4569,4618,393,401,46,18848
2022-06-25,15,8821,4903,4873,382,366,58,19403
2022-06-25,16,8821,4788,5000,496,291,57,19453
2022-06-25,17,8823,5071,5077,520,228,61,19780
2022-06-25,18,8821,4968,5085,532,115,57,19578
2022-06-25,19,8816,4993,5134,538,45,53,19579
2022-06-25,20,8803,4569,4865,596,11,12,18856
2022-06-25,21,8805,4116,4723,889,0,0,18533
2022-06-25,22,8797,3751,4260,1298,0,0,18106
2022-06-25,23,8800,2394,4061,1422,0,0,16677
2022-06-25,24,8813,1199,4083,1634,0,0,15729
2022-06-26,1,8809,712,4050,1661,0,1,15233
2022-06-26,2,8815,582,4043,1726,0,1,15167
2022-06-26,3,8816,521,4177,1499,0,0,15013
2022-06-26,4,8811,505,4085,1356,0,0,14757
2022-06-26,5,8804,253,3962,1479,1,0,14499
2022-06-26,6,8804,216,3789,1516,5,0,14330
2022-06-26,7,8798,213,4130,1078,44,0,14263
2022-06-26,8,8782,449,4391,1009,84,0,14715
2022-06-26,9,8779,898,4380,1013,152,0,15222
2022-06-26,10,8778,1939,4427,972,247,1,16364
2022-06-26,11,8782,3202,4383,977,247,2,17593
2022-06-26,12,8779,3918,4615,1154,220,16,18702
2022-06-26,13,8786,4158,4362,1345,198,48,18897
2022-06-26,14,8785,3929,4890,1390,148,53,19195
2022-06-26,15,8779,3968,4914,1398,172,53,19284
2022-06-26,16,8782,4150,5180,1619,151,53,19935
2022-06-26,17,8779,4504,5219,1754,146,53,20455
2022-06-26,18,8778,4803,5180,1733,98,54,20646
2022-06-26,19,8776,4689,5012,1824,34,57,20392
2022-06-26,20,8763,3982,4754,2393,8,56,19956
2022-06-26,21,8755,3275,4726,2622,1,31,19410
2022-06-26,22,8733,3821,4267,2367,0,0,19188
2022-06-26,23,8746,2641,3984,2062,0,0,17433
2022-06-26,24,8745,1516,3805,2132,0,0,16198
2022-06-27,1,8749,476,3802,2124,0,6,15157
2022-06-27,2,8759,205,3849,1992,0,11,14816
2022-06-27,3,8803,208,4032,1727,0,11,14781
2022-06-27,4,8778,256,4462,1731,0,11,15238
2022-06-27,5,8782,383,3572,1954,1,11,14703
2022-06-27,6,8784,600,3556,2166,13,11,15130
2022-06-27,7,8783,664,3842,2129,62,11,15491
2022-06-27,8,8784,759,3795,2597,160,11,16106
2022-06-27,9,8777,1039,3902,2409,268,11,16406
2022-06-27,10,8780,1425,3851,2384,326,10,16776
2022-06-27,11,8783,1764,3953,2365,337,10,17212
2022-06-27,12,8774,1787,3964,2342,326,10,17203
2022-06-27,13,8776,1797,4299,2335,304,10,17521
2022-06-27,14,8770,1797,4225,2246,305,10,17353
2022-06-27,15,8779,1910,4039,2095,244,20,17087
2022-06-27,16,8778,2059,4333,1957,196,28,17351
2022-06-27,17,8783,2156,4685,1690,163,54,17531
2022-06-27,18,8783,1877,4869,1402,105,54,17090
2022-06-27,19,8780,1813,4576,1364,35,46,16614
2022-06-27,20,8794,1829,4590,1088,8,44,16353
2022-06-27,21,8792,2268,4520,1030,0,35,16645
2022-06-27,22,8789,2258,4220,900,0,30,16197
2022-06-27,23,8788,1558,3886,599,0,27,14858
2022-06-27,24,8783,784,3880,539,0,21,14007
2022-06-28,1,8788,237,3603,428,0,25,13081
2022-06-28,2,8790,175,3626,466,0,28,13085
2022-06-28,3,8788,174,3861,473,0,27,13323
2022-06-28,4,8777,311,4034,561,0,18,13701
2022-06-28,5,8786,520,3511,513,1,19,13350
2022-06-28,6,8798,1093,3553,330,12,25,13811
2022-06-28,7,8802,1388,4066,272,61,26,14615
2022-06-28,8,8852,1730,4086,184,178,25,15055
2022-06-28,9,8852,2009,4064,231,287,25,15468
2022-06-28,10,8870,2229,4115,346,315,21,15896
2022-06-28,11,9045,2406,3949,494,350,17,16261
2022-06-28,12,9035,2244,4029,638,356,17,16319
2022-06-28,13,8981,2273,3701,860,347,15,16177
2022-06-28,14,8968,2386,3656,757,369,15,16151
2022-06-28,15,8962,2417,3811,557,376,25,16148
2022-06-28,16,8961,2593,4020,1056,318,26,16974
2022-06-28,17,8941,2632,4635,1346,234,24,17812
2022-06-28,18,9050,2579,4981,1458,124,25,18217
2022-06-28,19,9165,2587,4811,1368,32,24,17987
2022-06-28,20,9172,2626,4470,1309,7,23,17607
2022-06-28,21,9173,2304,4365,1519,1,23,17385
2022-06-28,22,9319,1324,3934,1808,0,17,16402
2022-06-28,23,9367,489,4178,1730,0,11,15775
2022-06-28,24,9363,245,4145,1517,0,11,15281
2022-06-29,1,9367,199,3891,1444,0,11,14912
2022-06-29,2,9357,178,3414,1290,0,11,14250
2022-06-29,3,9360,180,3278,1212,0,11,14041
2022-06-29,4,9367,193,3338,1251,1,11,14161
2022-06-29,5,9374,249,3324,1135,2,11,14095
2022-06-29,6,9378,401,3563,764,14,11,14131
2022-06-29,7,9372,568,4083,544,60,11,14638
2022-06-29,8,9370,1013,4153,523,112,11,15182
2022-06-29,9,9377,1162,4227,237,166,11,15180
2022-06-29,10,9441,1865,4006,142,212,11,15677
2022-06-29,11,9527,2228,4062,142,179,11,16149
2022-06-29,12,9528,2218,4024,206,215,12,16203
2022-06-29,13,9528,2236,3870,351,259,11,16255
2022-06-29,14,9533,2278,4066,419,244,11,16551
2022-06-29,15,9534,2413,4017,437,253,18,16672
2022-06-29,16,9531,2665,4162,511,273,24,17166
2022-06-29,17,9546,2583,4656,482,199,24,17490
2022-06-29,18,9551,2498,4833,419,99,24,17424
2022-06-29,19,9550,2488,5069,313,30,23,17473
2022-06-29,20,9539,2508,5112,213,9,23,17404
2022-06-29,21,9531,2259,4725,256,0,23,16794
2022-06-29,22,9532,2360,4204,368,0,15,16479
2022-06-29,23,9540,1679,3871,344,0,11,15445
2022-06-29,24,9562,867,3603,598,0,11,14641
2022-06-30,1,9563,746,3349,965,0,11,14634
2022-06-30,2,9566,605,3211,1151,0,11,14544
2022-06-30,3,9575,550,3277,1163,0,11,14576
2022-06-30,4,9581,550,3368,1320,1,11,14831
2022-06-30,5,9581,552,3054,1325,2,11,14525
2022-06-30,6,9589,611,3344,1118,15,11,14688
2022-06-30,7,9591,725,4008,949,58,11,15342
2022-06-30,8,9598,1060,4831,921,124,11,16545
2022-06-30,9,9513,1200,5012,944,191,11,16871
2022-06-30,10,9501,1194,4711,1011,321,11,16749
2022-06-30,11,9494,1598,4414,1254,355,16,17131
2022-06-30,12,9535,1919,4147,1651,366,30,17648
2022-06-30,13,9567,2109,4084,1935,378,58,18131
2022-06-30,14,9582,2185,4067,2039,361,61,18295
2022-06-30,15,9550,2224,4085,2566,346,67,18838
2022-06-30,16,9552,2305,4318,2644,283,73,19175
2022-06-30,17,9544,2443,4756,2715,194,74,19726
2022-06-30,18,9554,2548,5100,2360,115,74,19751
2022-06-30,19,9562,2316,5106,2236,40,75,19335
2022-06-30,20,9566,1909,5047,2257,8,32,18819
2022-06-30,21,9547,1549,4655,2694,1,23,18469
2022-06-30,22,9545,1152,4230,3023,0,14,17964
2022-06-30,23,9548,976,3532,2966,0,11,17033
2022-06-30,24,9551,638,3057,3128,0,11,16385
2022-07-01,1,9550,399,3014,3040,0,11,16014
2022-07-01,2,9563,367,3026,2722,0,12,15690
2022-07-01,3,9563,367,2928,2410,0,18,15286
2022-07-01,4,9566,371,2910,2255,0,36,15138
2022-07-01,5,9565,393,2903,2297,1,36,15195
2022-07-01,6,9570,552,3214,2350,5,35,15726
2022-07-01,7,9569,838,3433,1806,48,27,15721
2022-07-01,8,9559,1477,3900,1334,120,30,16420
2022-07-01,9,9562,1591,4131,1206,181,68,16739
2022-07-01,10,9557,1812,4272,1066,205,76,16988
2022-07-01,11,9549,2289,4362,935,259,76,17470
2022-07-01,12,9535,2229,4291,984,223,76,17338
2022-07-01,13,9532,2191,4296,1124,189,76,17408
2022-07-01,14,9525,2389,4059,1284,305,76,17638
2022-07-01,15,9528,2633,4110,1492,234,76,18073
2022-07-01,16,9533,2744,4096,1571,181,76,18201
2022-07-01,17,9537,2816,4455,1441,126,79,18454
2022-07-01,18,9534,2725,4563,1554,63,77,18516
2022-07-01,19,9532,2696,4415,1360,25,77,18105
2022-07-01,20,9529,2533,4406,1459,5,76,18008
2022-07-01,21,9524,1840,4185,1866,0,77,17492
2022-07-01,22,9524,1239,4275,1737,0,82,16857
2022-07-01,23,9529,770,4045,1560,0,94,15998
2022-07-01,24,9526,719,3849,1341,0,91,15526
2022-07-02,1,9534,628,3634,1237,0,27,15060
2022-07-02,2,9544,585,3456,970,0,21,14576
2022-07-02,3,9551,563,3528,659,0,21,14322
2022-07-02,4,9546,429,3570,665,0,21,14231
2022-07-02,5,9545,364,3309,772,0,21,14011
2022-07-02,6,9547,399,3182,505,9,21,13663
2022-07-02,7,9550,508,3216,521,59,21,13875
2022-07-02,8,9549,763,3677,471,168,26,14654
2022-07-02,9,9539,879,3924,592,278,29,15241
2022-07-02,10,9533,1041,4241,588,361,36,15800
2022-07-02,11,9528,1326,4406,632,407,51,16350
2022-07-02,12,9528,1689,4177,836,411,84,16725
2022-07-02,13,9524,2027,3816,1164,381,85,16997
2022-07-02,14,9516,2379,3763,1497,394,85,17634
2022-07-02,15,9513,2496,3635,1158,360,85,17247
2022-07-02,16,9511,2506,3683,1554,295,85,17634
2022-07-02,17,9511,2507,4000,1539,206,85,17848
2022-07-02,18,9519,2504,4507,1330,131,86,18077
2022-07-02,19,9532,2337,4742,1069,40,86,17806
2022-07-02,20,9545,1936,4474,929,10,86,16980
2022-07-02,21,9541,1490,3947,838,0,86,15902
2022-07-02,22,9544,1204,3873,906,0,86,15613
2022-07-02,23,9550,1023,3788,832,0,86,15279
2022-07-02,24,9550,782,3726,926,0,47,15031
2022-07-03,1,9553,563,3444,1167,0,26,14753
2022-07-03,2,9556,234,3428,942,0,22,14182
2022-07-03,3,9557,153,3648,829,0,22,14209
2022-07-03,4,9569,153,3569,789,1,22,14103
2022-07-03,5,9566,165,3362,698,2,22,13815
2022-07-03,6,9567,172,3484,576,8,22,13829
2022-07-03,7,9569,271,3662,334,58,26,13920
2022-07-03,8,9568,587,3896,128,172,31,14382
2022-07-03,9,9563,796,3702,54,248,33,14396
2022-07-03,10,9560,1192,3737,18,295,33,14835
2022-07-03,11,9544,1470,4236,140,406,46,15842
2022-07-03,12,9535,1813,4031,205,415,78,16077
2022-07-03,13,9523,2189,3567,246,398,85,16008
2022-07-03,14,9524,2393,3623,147,239,85,16011
2022-07-03,15,9527,2484,3674,493,386,85,16649
2022-07-03,16,9531,2497,3841,568,325,73,16835
2022-07-03,17,9541,2341,4633,728,238,32,17513
2022-07-03,18,9552,2624,5023,644,127,33,18003
2022-07-03,19,9554,2839,5065,485,37,33,18013
2022-07-03,20,9561,2795,4656,414,9,33,17468
2022-07-03,21,9562,2430,4482,458,0,34,16966
2022-07-03,22,9569,2057,3790,590,0,35,16041
2022-07-03,23,9571,1402,3387,584,0,35,14979
2022-07-03,24,9578,649,3286,606,0,33,14152
2022-07-04,1,9585,562,3122,631,0,29,13929
2022-07-04,2,9587,561,3183,588,0,23,13942
2022-07-04,3,9584,564,3284,573,0,21,14026
2022-07-04,4,9589,617,3541,505,1,21,14274
2022-07-04,5,9581,711,3131,427,2,22,13874
2022-07-04,6,9577,994,3088,359,11,26,14055
2022-07-04,7,9578,1359,3384,96,37,40,14494
2022-07-04,8,9576,1393,4118,146,132,44,15409
2022-07-04,9,9577,1551,4031,118,229,34,15540
2022-07-04,10,9602,1836,3861,129,336,34,15798
2022-07-04,11,9587,2379,4232,195,400,55,16848
2022-07-04,12,9591,2608,4022,344,377,87,17029
2022-07-04,13,9564,2896,4311,423,348,106,17648
2022-07-04,14,9418,3335,4318,536,337,108,18052
2022-07-04,15,9385,3121,4379,547,282,106,17820
2022-07-04,16,9479,3253,4469,447,245,107,18000
2022-07-04,17,9542,3387,4858,432,183,88,18490
2022-07-04,18,9548,3357,4968,417,107,48,18445
2022-07-04,19,9555,3285,4997,452,36,34,18359
2022-07-04,20,9557,2895,4981,594,8,34,18069
2022-07-04,21,9561,2852,4697,970,0,34,18114
2022-07-04,22,9567,2532,4141,1064,0,33,17337
2022-07-04,23,9572,1823,3928,1475,0,34,16832
2022-07-04,24,9577,1208,3654,1736,0,26,16201
2022-07-05,1,9575,649,3595,1707,0,22,15548
2022-07-05,2,9565,421,3574,1955,0,24,15539
2022-07-05,3,9551,379,3466,2060,0,24,15480
2022-07-05,4,9547,379,3374,2350,0,23,15673
2022-07-05,5,9558,391,3308,2211,0,25,15493
2022-07-05,6,9557,618,3310,2174,1,47,15707
2022-07-05,7,9545,1043,3923,2372,6,78,16967
2022-07-05,8,9549,1719,4270,1956,17,85,17596
2022-07-05,9,9541,2072,4028,1989,30,85,17745
2022-07-05,10,9530,2344,3827,1806,81,84,17672
2022-07-05,11,9529,2607,3998,1875,144,84,18237
2022-07-05,12,9521,2690,4073,2036,124,84,18528
2022-07-05,13,9514,2817,3916,1764,134,84,18229
2022-07-05,14,9501,2972,3886,1562,211,84,18216
2022-07-05,15,9504,3139,3974,1425,153,84,18279
2022-07-05,16,9508,3250,4135,1559,163,84,18699
2022-07-05,17,9508,3489,4605,1437,110,84,19233
2022-07-05,18,9511,3842,4753,1197,56,85,19444
2022-07-05,19,9510,3636,4747,1049,23,85,19050
2022-07-05,20,9510,3215,4697,857,3,87,18369
2022-07-05,21,9499,3053,4695,826,0,87,18160
2022-07-05,22,9499,2595,4324,817,0,87,17322
2022-07-05,23,9505,1856,4045,696,0,43,16145
2022-07-05,24,9509,1577,4102,504,0,34,15726
2022-07-06,1,9508,1322,4188,293,0,25,15336
2022-07-06,2,9516,755,4055,221,0,18,14565
2022-07-06,3,9520,726,4063,266,0,11,14586
2022-07-06,4,9509,754,3965,284,0,13,14525
2022-07-06,5,9505,850,3831,234,1,30,14451
2022-07-06,6,9511,1311,3801,288,7,48,14966
2022-07-06,7,9512,1678,3688,220,40,106,15244
2022-07-06,8,9508,1959,4268,455,110,121,16421
2022-07-06,9,9493,2065,4281,396,166,110,16511
2022-07-06,10,9454,2296,4201,381,252,110,16694
2022-07-06,11,9334,2586,4345,299,252,111,16927
2022-07-06,12,9481,2588,4434,296,249,72,17120
2022-07-06,13,9515,2698,4288,308,284,66,17159
2022-07-06,14,9458,2773,4507,346,274,73,17431
2022-07-06,15,9468,2856,4467,372,253,68,17484
2022-07-06,16,9515,3142,4646,439,249,83,18074
2022-07-06,17,9510,3376,4681,486,227,113,18393
2022-07-06,18,9515,3075,4871,436,128,122,18147
2022-07-06,19,9518,3348,4988,403,36,121,18414
2022-07-06,20,9517,3050,4862,511,10,116,18066
2022-07-06,21,9521,2965,4733,586,0,112,17917
2022-07-06,22,9517,2871,4473,562,0,58,17481
2022-07-06,23,9530,2201,4169,528,0,56,16484
2022-07-06,24,9530,1749,4023,483,0,59,15844
2022-07-07,1,9541,1062,3717,462,0,57,14839
2022-07-07,2,9544,767,3904,411,0,51,14677
2022-07-07,3,9562,1200,3566,318,0,60,14706
2022-07-07,4,9559,1269,3551,281,0,58,14718
2022-07-07,5,9558,1318,3598,320,2,51,14847
2022-07-07,6,9562,1720,3582,90,5,67,15026
2022-07-07,7,9561,1979,3772,74,45,105,15536
2022-07-07,8,9560,2149,3917,65,154,107,15952
2022-07-07,9,9558,2535,4142,57,264,97,16653
2022-07-07,10,9546,2579,4240,66,335,99,16865
2022-07-07,11,9546,2691,4465,90,363,99,17254
2022-07-07,12,9544,2899,4522,160,361,96,17582
2022-07-07,13,9545,3195,4609,201,359,101,18010
2022-07-07,14,9545,3503,4636,218,364,100,18366
2022-07-07,15,9544,3617,4737,316,358,103,18675
2022-07-07,16,9537,3972,5018,341,286,100,19254
2022-07-07,17,9529,4336,5222,332,207,115,19741
2022-07-07,18,9532,4208,5222,349,116,115,19542
2022-07-07,19,9535,4299,5184,345,37,109,19509
2022-07-07,20,9543,4081,4964,372,8,107,19075
2022-07-07,21,9549,4037,4736,386,1,102,18811
2022-07-07,22,9553,3110,4711,444,0,87,17905
2022-07-07,23,9558,2186,4325,401,0,86,16556
2022-07-07,24,9562,1569,3954,379,0,86,15550
2022-07-08,1,9563,737,3537,327,0,77,14241
2022-07-08,2,9561,272,3484,446,0,75,13838
2022-07-08,3,9558,244,3413,526,0,75,13816
2022-07-08,4,9561,479,3193,371,0,75,13679
2022-07-08,5,9555,872,3186,385,2,53,14053
2022-07-08,6,9559,1299,3347,261,7,24,14497
2022-07-08,7,9563,1645,3623,183,43,30,15087
2022-07-08,8,9556,2124,4071,228,152,34,16165
2022-07-08,9,9557,2654,4255,201,246,36,16949
2022-07-08,10,9554,3207,4272,218,330,64,17645
2022-07-08,11,9543,3431,4484,304,310,95,18167
2022-07-08,12,9535,3779,4480,440,292,179,18705
2022-07-08,13,9539,3703,4378,531,313,129,18593
2022-07-08,14,9532,3456,4662,665,235,86,18636
2022-07-08,15,9524,3723,4734,706,201,87,18975
2022-07-08,16,9515,3757,4937,807,183,88,19287
2022-07-08,17,9528,3885,4919,1145,146,98,19721
2022-07-08,18,9539,3291,5129,1251,104,86,19400
2022-07-08,19,9543,3441,4847,1121,37,87,19076
2022-07-08,20,9550,3079,4701,1178,9,88,18605
2022-07-08,21,9547,2163,4596,1346,0,88,17740
2022-07-08,22,9555,1971,3769,1325,0,88,16708
2022-07-08,23,9555,707,3541,1143,0,88,15034
2022-07-08,24,9555,191,3373,1286,0,45,14450
2022-07-09,1,9564,141,3125,1335,0,25,14190
2022-07-09,2,9566,141,3007,1628,0,22,14364
2022-07-09,3,9570,137,2990,1763,0,22,14482
2022-07-09,4,9563,140,3005,1851,0,22,14581
2022-07-09,5,9564,140,2973,1952,1,22,14652
2022-07-09,6,9564,172,3176,1797,8,22,14739
2022-07-09,7,9560,180,3436,1361,55,32,14624
2022-07-09,8,9558,245,4041,1011,170,35,15060
2022-07-09,9,9557,345,3631,866,298,34,14731
2022-07-09,10,9557,493,3828,680,388,41,14987
2022-07-09,11,9549,775,4219,567,422,74,15606
2022-07-09,12,9543,862,4239,652,427,82,15805
2022-07-09,13,9547,1027,3905,744,420,82,15725
2022-07-09,14,9538,1632,3723,771,423,109,16196
2022-07-09,15,9532,1792,3705,483,403,115,16030
2022-07-09,16,9528,1910,3729,739,357,89,16352
2022-07-09,17,9525,1837,4195,1248,260,82,17147
2022-07-09,18,9517,1902,4522,1152,139,85,17317
2022-07-09,19,9521,2239,4558,806,38,85,17247
2022-07-09,20,9517,2048,4488,652,9,92,16806
2022-07-09,21,9525,1725,4191,739,0,87,16267
2022-07-09,22,9530,1678,3729,852,0,86,15875
2022-07-09,23,9534,594,3754,784,0,45,14711
2022-07-09,24,9538,195,3379,682,0,34,13828
2022-07-10,1,9542,141,3270,644,0,24,13621
2022-07-10,2,9540,140,3502,570,0,22,13774
2022-07-10,3,9535,139,3729,570,0,22,13995
2022-07-10,4,9539,138,3493,596,1,22,13789
2022-07-10,5,9539,154,3539,587,2,23,13844
2022-07-10,6,9538,159,3637,449,11,23,13817
2022-07-10,7,9538,336,4125,385,57,29,14470
2022-07-10,8,9536,529,3691,295,161,33,14245
2022-07-10,9,9534,639,4191,290,273,34,14961
2022-07-10,10,9534,824,3999,457,364,34,15212
2022-07-10,11,9524,1075,4205,567,401,36,15808
2022-07-10,12,9516,1569,4122,601,416,34,16258
2022-07-10,13,9498,1976,3951,522,408,33,16388
2022-07-10,14,9499,2469,4200,568,401,33,17170
2022-07-10,15,9441,2698,4036,537,380,32,17124
2022-07-10,16,9011,3069,4350,545,331,33,17339
2022-07-10,17,8677,3996,4784,466,227,33,18183
2022-07-10,18,8690,4152,4860,433,120,33,18288
2022-07-10,19,8692,4282,4721,491,33,33,18252
2022-07-10,20,8698,4032,4455,589,8,33,17815
2022-07-10,21,8694,3384,4414,717,1,33,17243
2022-07-10,22,8706,3314,3983,783,0,31,16817
2022-07-10,23,8709,2380,3770,1002,0,31,15892
2022-07-10,24,8704,1358,3590,1104,0,31,14787
2022-07-11,1,8707,807,3222,1087,0,22,13845
2022-07-11,2,8714,735,3350,1048,0,20,13867
2022-07-11,3,8694,875,3409,1087,0,20,14085
2022-07-11,4,8677,825,3392,1182,0,19,14095
2022-07-11,5,8689,832,3186,1119,1,20,13847
2022-07-11,6,8674,1023,3126,1098,6,20,13947
2022-07-11,7,8667,1367,3261,1067,55,26,14443
2022-07-11,8,8656,1816,3822,1072,120,26,15512
2022-07-11,9,8645,2120,4034,1207,184,24,16214
2022-07-11,10,8649,2396,4039,1819,299,24,17226
2022-07-11,11,8631,2635,4198,2247,375,24,18110
2022-07-11,12,8606,2727,4287,2740,356,25,18741
2022-07-11,13,8618,2871,4101,3084,378,24,19076
2022-07-11,14,8625,2993,4122,3235,383,24,19382
2022-07-11,15,8623,3173,4427,3367,342,25,19957
2022-07-11,16,8606,3603,4590,3191,303,26,20319
2022-07-11,17,8591,3894,4851,3145,187,24,20692
2022-07-11,18,8600,3930,4946,3091,102,24,20693
2022-07-11,19,8601,4031,4728,2909,37,24,20330
2022-07-11,20,8603,3833,4970,2647,5,24,20082
2022-07-11,21,8586,4054,4741,2436,0,24,19841
2022-07-11,22,8575,3437,4482,2357,0,24,18875
2022-07-11,23,8591,2465,4066,2422,0,24,17568
2022-07-11,24,8598,1172,4001,2544,0,24,16339
2022-07-12,1,8611,818,3661,2470,0,15,15575
2022-07-12,2,8624,538,3765,2257,0,11,15195
2022-07-12,3,8647,494,3504,2365,0,11,15021
2022-07-12,4,8673,417,3498,2500,0,11,15099
2022-07-12,5,8682,714,3204,2254,2,11,14867
2022-07-12,6,8693,1378,3276,1862,4,11,15224
2022-07-12,7,8695,2338,3814,1688,37,9,16581
2022-07-12,8,8697,3734,3752,1483,126,9,17801
2022-07-12,9,8689,3817,3776,1433,229,9,17953
2022-07-12,10,8664,3825,3708,1855,297,9,18358
2022-07-12,11,8652,3719,3866,2067,279,11,18594
2022-07-12,12,8630,4039,4386,1882,266,18,19221
2022-07-12,13,8630,4399,4454,1535,258,24,19300
2022-07-12,14,8616,4309,4485,1196,325,24,18955
2022-07-12,15,8618,4263,4870,1161,341,23,19276
2022-07-12,16,8617,4577,4923,1228,301,20,19666
2022-07-12,17,8638,4812,5139,1233,232,21,20075
2022-07-12,18,8667,4897,5154,1155,113,20,20006
2022-07-12,19,8690,4832,5148,1077,35,23,19805
2022-07-12,20,8706,4170,5268,697,7,24,18872
2022-07-12,21,8794,4388,4930,453,0,24,18589
2022-07-12,22,9132,3665,4498,360,0,24,17679
2022-07-12,23,9364,2735,4192,223,0,24,16538
2022-07-12,24,9404,1764,3989,236,0,24,15417
2022-07-13,1,9398,1676,3679,255,0,18,15026
2022-07-13,2,9390,1095,3527,271,0,11,14294
2022-07-13,3,9392,1031,3414,288,0,11,14136
2022-07-13,4,9399,1236,3436,232,0,11,14314
2022-07-13,5,9393,1363,3402,214,0,11,14383
2022-07-13,6,9386,1414,3332,228,10,12,14382
2022-07-13,7,9379,1810,3772,187,60,18,15226
2022-07-13,8,9373,2564,3978,77,162,24,16178
2022-07-13,9,9360,3177,4066,36,257,24,16920
2022-07-13,10,9361,3445,4386,43,321,26,17582
2022-07-13,11,9397,3724,4488,71,345,25,18050
2022-07-13,12,9429,3465,4227,110,318,25,17574
2022-07-13,13,9429,3353,4196,166,270,24,17438
2022-07-13,14,9425,3739,4232,185,265,25,17871
2022-07-13,15,9428,4086,4255,152,214,24,18159
2022-07-13,16,9430,4093,4474,108,185,24,18314
2022-07-13,17,9421,3730,4601,93,150,25,18020
2022-07-13,18,9417,3583,4622,159,77,25,17883
2022-07-13,19,9412,3839,4642,160,31,25,18109
2022-07-13,20,9408,4030,4600,114,7,48,18207
2022-07-13,21,9426,3873,4467,121,0,76,17963
2022-07-13,22,9442,3123,4117,186,0,76,16944
2022-07-13,23,9445,1935,3843,249,0,75,15547
2022-07-13,24,9439,1210,3551,248,0,83,14531
2022-07-14,1,9435,704,3543,293,0,77,14052
2022-07-14,2,9424,561,3459,306,0,62,13812
2022-07-14,3,9426,704,3571,343,0,23,14067
2022-07-14,4,9542,529,3314,421,0,11,13817
2022-07-14,5,9636,514,3093,368,2,11,13624
2022-07-14,6,9633,635,3272,353,8,14,13915
2022-07-14,7,9636,940,3818,309,53,30,14786
2022-07-14,8,9632,2010,3922,110,165,60,15899
2022-07-14,9,9637,2214,3916,35,279,91,16172
2022-07-14,10,9649,2803,3842,35,374,82,16785
2022-07-14,11,9623,2961,3952,126,407,77,17146
2022-07-14,12,9622,3336,3990,223,403,85,17659
2022-07-14,13,9635,3190,4092,322,372,89,17700
2022-07-14,14,9816,3008,4081,426,332,92,17755
2022-07-14,15,9935,3059,4131,530,354,92,18101
2022-07-14,16,10018,3202,4539,570,287,95,18711
2022-07-14,17,10003,3673,4978,477,238,83,19452
2022-07-14,18,10000,3868,5154,387,124,92,19625
2022-07-14,19,10001,4087,5164,333,31,111,19727
2022-07-14,20,9989,3873,4869,380,6,88,19205
2022-07-14,21,10002,3356,4786,378,0,73,18595
2022-07-14,22,10016,2979,4305,303,0,73,17676
2022-07-14,23,10036,1617,4051,319,0,74,16097
2022-07-14,24,10056,850,3841,296,0,74,15117
2022-07-15,1,10116,604,3579,261,0,65,14625
2022-07-15,2,10238,622,3594,195,0,20,14669
2022-07-15,3,10245,561,3491,117,0,13,14427
2022-07-15,4,10241,614,3553,78,0,14,14500
2022-07-15,5,10237,523,3281,80,1,11,14133
2022-07-15,6,10220,523,3274,67,8,14,14106
2022-07-15,7,10205,646,4037,88,55,48,15079
2022-07-15,8,10195,1086,4206,57,164,73,15781
2022-07-15,9,10179,1506,4404,23,278,92,16482
2022-07-15,10,10165,2122,4387,73,358,78,17183
2022-07-15,11,10163,2450,4322,109,381,71,17496
2022-07-15,12,10143,2553,4325,223,383,71,17698
2022-07-15,13,10137,2854,4305,324,367,71,18058
2022-07-15,14,10130,3075,4423,350,372,70,18420
2022-07-15,15,10125,3305,4521,402,348,55,18756
2022-07-15,16,10135,3656,4607,431,287,69,19185
2022-07-15,17,10172,3676,4802,395,197,96,19338
2022-07-15,18,10209,3666,4851,332,98,81,19237
2022-07-15,19,10240,3533,4806,253,36,81,18949
2022-07-15,20,10242,3237,4802,299,7,73,18660
2022-07-15,21,10243,3250,4611,459,0,96,18659
2022-07-15,22,10236,2265,4412,527,0,88,17528
2022-07-15,23,10233,1332,3780,504,0,72,15921
2022-07-15,24,10223,601,3640,452,0,72,14988
2022-07-16,1,10201,579,3619,305,0,28,14732
2022-07-16,2,10189,580,3520,344,0,11,14644
2022-07-16,3,10188,470,3270,444,0,11,14383
2022-07-16,4,10200,485,3307,289,0,11,14292
2022-07-16,5,10218,546,3430,165,1,11,14371
2022-07-16,6,10228,520,3367,136,8,11,14270
2022-07-16,7,10231,628,3503,111,52,21,14546
2022-07-16,8,10220,799,3953,69,153,24,15218
2022-07-16,9,10219,1309,3930,44,230,24,15756
2022-07-16,10,10227,2015,3979,60,352,24,16657
2022-07-16,11,10225,2565,4028,131,380,24,17353
2022-07-16,12,10213,2684,4261,188,361,24,17731
2022-07-16,13,10196,3099,4255,215,361,49,18175
2022-07-16,14,10176,3323,4220,262,388,74,18443
2022-07-16,15,10154,3244,4275,300,357,81,18411
2022-07-16,16,10143,3710,4408,233,307,156,18957
2022-07-16,17,10153,4483,4506,158,217,212,19729
2022-07-16,18,10173,4533,4494,116,120,195,19631
2022-07-16,19,10188,4456,4479,95,36,199,19453
2022-07-16,20,10206,3993,4325,122,7,187,18840
2022-07-16,21,10207,3674,4245,153,0,167,18446
2022-07-16,22,10210,3198,3830,264,0,98,17600
2022-07-16,23,10209,2202,3738,349,0,89,16587
2022-07-16,24,10205,1261,3393,352,0,53,15264
2022-07-17,1,10216,780,3326,302,0,19,14643
2022-07-17,2,10220,559,3463,229,0,11,14482
2022-07-17,3,10225,493,3257,209,0,11,14195
2022-07-17,4,10230,490,3184,173,0,24,14101
2022-07-17,5,10223,515,3281,138,0,19,14176
2022-07-17,6,10206,533,3171,211,4,11,14136
2022-07-17,7,10177,681,3145,182,39,20,14244
2022-07-17,8,10155,1029,3518,140,112,44,14998
2022-07-17,9,10144,1563,3475,118,191,73,15564
2022-07-17,10,10147,2285,3827,161,259,102,16781
2022-07-17,11,10158,2922,3848,222,279,201,17630
2022-07-17,12,10171,3364,4181,170,297,187,18370
2022-07-17,13,10180,3485,4225,242,323,158,18613
2022-07-17,14,10173,3780,4214,501,287,96,19051
2022-07-17,15,10168,4127,4424,496,235,114,19564
2022-07-17,16,10170,4442,4371,481,212,185,19861
2022-07-17,17,10173,4427,4429,531,176,186,19922
2022-07-17,18,10175,4140,4607,526,94,159,19701
2022-07-17,19,10173,3986,4668,381,36,57,19301
2022-07-17,20,10173,4382,4472,406,5,27,19465
2022-07-17,21,10161,4081,4279,635,0,56,19212
2022-07-17,22,10156,3621,3907,597,0,76,18357
2022-07-17,23,10157,2601,3711,563,0,73,17105
2022-07-17,24,10180,1922,3436,632,0,33,16203
2022-07-18,1,10175,874,3516,574,0,14,15153
2022-07-18,2,10127,764,3269,561,0,11,14732
2022-07-18,3,10117,617,3218,525,0,11,14488
2022-07-18,4,10119,761,3293,473,0,11,14657
2022-07-18,5,10122,741,3079,558,0,11,14511
2022-07-18,6,10123,1364,3263,502,4,31,15287
2022-07-18,7,10116,2029,3409,496,9,74,16133
2022-07-18,8,10109,2679,3776,535,25,118,17242
2022-07-18,9,10099,3341,3852,582,62,160,18096
2022-07-18,10,10092,3717,3895,579,103,152,18538
2022-07-18,11,10071,4001,3895,507,123,119,18716
2022-07-18,12,10073,4178,3924,659,161,98,19093
2022-07-18,13,10079,4028,4207,680,181,75,19250
2022-07-18,14,10078,4073,4276,583,155,75,19240
2022-07-18,15,10084,4309,4376,583,195,75,19622
2022-07-18,16,10096,4484,4653,703,211,76,20223
2022-07-18,17,10106,4624,4932,762,165,93,20682
2022-07-18,18,10116,4637,5152,734,79,126,20844
2022-07-18,19,10120,4939,5068,625,39,206,20997
2022-07-18,20,10127,4625,4864,720,8,202,20546
2022-07-18,21,10135,4284,4389,879,0,169,19856
2022-07-18,22,10160,3623,3964,1028,0,104,18879
2022-07-18,23,10170,2553,3336,1439,0,36,17534
2022-07-18,24,10159,1712,2964,1566,0,24,16425
2022-07-19,1,10150,686,2894,1962,0,15,15707
2022-07-19,2,10150,542,3289,1685,0,11,15677
2022-07-19,3,10134,732,3346,1444,0,12,15668
2022-07-19,4,10118,637,3167,1349,0,13,15284
2022-07-19,5,10096,758,2893,1272,2,14,15035
2022-07-19,6,10087,1364,2851,879,4,22,15207
2022-07-19,7,10080,1936,3199,934,43,64,16256
2022-07-19,8,10090,2740,3712,810,140,80,17572
2022-07-19,9,10090,3655,3838,577,253,153,18566
2022-07-19,10,10088,4007,3833,565,346,203,19042
2022-07-19,11,10084,4574,3874,697,389,202,19820
2022-07-19,12,10097,4541,4132,994,398,178,20340
2022-07-19,13,10123,4643,4148,1297,401,187,20799
2022-07-19,14,10153,4813,4309,1413,367,167,21222
2022-07-19,15,10162,4947,4565,1575,368,160,21777
2022-07-19,16,10150,4847,4921,1718,312,139,22087
2022-07-19,17,10137,4825,5150,1695,227,87,22121
2022-07-19,18,10121,5011,5160,1625,110,46,22073
2022-07-19,19,10100,5057,5165,1528,31,33,21914
2022-07-19,20,10089,5373,4856,1321,3,39,21681
2022-07-19,21,10093,5311,4606,1711,0,37,21758
2022-07-19,22,10126,4675,3761,1972,0,32,20566
2022-07-19,23,10135,4060,3428,1886,0,23,19532
2022-07-19,24,10137,3358,3108,2115,0,23,18741
2022-07-20,1,10144,2324,2879,2086,0,16,17449
2022-07-20,2,10140,2046,2780,1849,0,11,16826
2022-07-20,3,10144,2055,2873,1812,0,11,16895
2022-07-20,4,10151,2108,2806,1488,0,11,16564
2022-07-20,5,10149,2331,2833,1529,1,12,16855
2022-07-20,6,10138,2795,2889,1251,3,12,17088
2022-07-20,7,10142,3016,3227,1738,29,42,18194
2022-07-20,8,10134,3624,3746,2159,95,72,19830
2022-07-20,9,10125,4183,3741,2237,219,121,20626
2022-07-20,10,10116,4454,3732,2696,310,98,21406
2022-07-20,11,10119,4275,3750,3042,303,81,21570
2022-07-20,12,10121,4481,3846,3243,276,84,22051
2022-07-20,13,10113,4252,3894,3291,315,123,21988
2022-07-20,14,10116,4432,4390,3261,332,95,22626
2022-07-20,15,10106,4676,4422,3093,282,88,22667
2022-07-20,16,10100,4620,4844,3041,191,47,22843
2022-07-20,17,10102,4264,4873,3119,138,35,22531
2022-07-20,18,10123,3888,5003,3053,109,35,22211
2022-07-20,19,10127,4418,4952,2954,25,36,22512
2022-07-20,20,10131,4461,4969,2549,4,37,22151
2022-07-20,21,10122,4893,4465,2311,0,36,21827
2022-07-20,22,10098,3583,3996,2502,0,36,20215
2022-07-20,23,10071,2939,3294,2375,0,25,18704
2022-07-20,24,10051,1914,3049,2495,0,28,17537
2022-07-21,1,10070,1488,3168,2445,0,32,17203
2022-07-21,2,10091,1330,3243,2350,0,28,17042
2022-07-21,3,10102,1269,3242,2348,0,11,16972
2022-07-21,4,10125,1266,3150,2317,0,11,16869
2022-07-21,5,10152,1380,2977,2265,2,12,16788
2022-07-21,6,10193,1610,3098,1984,4,12,16901
2022-07-21,7,10206,1943,3529,2166,32,45,17921
2022-07-21,8,10209,2907,3769,2281,115,85,19366
2022-07-21,9,10201,3005,3804,2408,192,99,19709
2022-07-21,10,10188,3239,3878,2508,239,154,20206
2022-07-21,11,10187,3402,4139,2619,275,174,20796
2022-07-21,12,10189,3669,4326,2765,311,153,21413
2022-07-21,13,10180,3637,4159,2851,313,164,21304
2022-07-21,14,10174,3479,4251,2806,254,87,21051
2022-07-21,15,10178,3542,4372,2553,268,71,20984
2022-07-21,16,10204,3972,4549,2182,273,81,21261
2022-07-21,17,10223,4506,4596,1910,205,92,21532
2022-07-21,18,10239,4710,4744,1623,109,93,21518
2022-07-21,19,10256,4673,4717,1440,34,92,21212
2022-07-21,20,10267,4685,4532,1434,6,41,20965
2022-07-21,21,10271,4407,4372,1553,0,24,20627
2022-07-21,22,10272,3961,4119,1424,0,23,19799
2022-07-21,23,10280,3159,3564,1235,0,24,18262
2022-07-21,24,10287,1673,3706,944,0,24,16634
2022-07-22,1,10304,1290,3314,1099,0,16,16023
2022-07-22,2,10317,1181,3080,598,0,11,15187
2022-07-22,3,10319,1212,3137,658,0,11,15337
2022-07-22,4,10322,1235,3257,788,0,11,15613
2022-07-22,5,10322,1485,3028,681,1,12,15529
2022-07-22,6,10315,1833,3079,305,3,12,15547
2022-07-22,7,10310,2518,3409,351,46,27,16661
2022-07-22,8,10300,3080,4010,351,145,66,17952
2022-07-22,9,10295,3696,4255,262,270,75,18853
2022-07-22,10,10294,4270,4244,375,352,80,19615
2022-07-22,11,10294,4579,4329,504,392,94,20192
2022-07-22,12,10288,4845,4447,768,382,87,20817
2022-07-22,13,10274,4854,4384,1099,395,83,21089
2022-07-22,14,10274,4755,4423,1398,383,127,21360
2022-07-22,15,10280,4380,4428,1493,365,132,21078
2022-07-22,16,10285,4706,4511,1448,322,117,21389
2022-07-22,17,10286,4883,4585,1367,218,130,21469
2022-07-22,18,10284,4772,4836,1432,104,96,21524
2022-07-22,19,10278,4672,4919,1432,28,100,21429
2022-07-22,20,10277,4293,4631,1731,6,98,21036
2022-07-22,21,10264,3327,4558,2218,0,74,20441
2022-07-22,22,10287,2665,4099,2454,0,81,19586
2022-07-22,23,10291,1770,3555,2514,0,75,18205
2022-07-22,24,10293,862,3433,2341,0,37,16966
2022-07-23,1,10286,754,3569,1981,0,14,16604
2022-07-23,2,10276,755,3608,1473,0,11,16123
2022-07-23,3,10271,678,3464,1214,0,11,15638
2022-07-23,4,10276,737,3496,1103,0,13,15625
2022-07-23,5,10277,676,3109,1489,2,12,15565
2022-07-23,6,10292,886,3235,1196,5,14,15628
2022-07-23,7,10319,1400,3455,1297,47,29,16547
2022-07-23,8,10329,2132,3683,1219,111,65,17539
2022-07-23,9,10331,2916,3842,995,199,94,18377
2022-07-23,10,10308,3322,4097,1034,253,105,19119
2022-07-23,11,10304,3767,3951,1273,290,141,19726
2022-07-23,12,10298,4099,3943,1641,324,152,20457
2022-07-23,13,10291,3985,3918,2028,317,127,20666
2022-07-23,14,10288,4155,4049,2109,348,131,21080
2022-07-23,15,10283,4562,4268,1545,349,112,21119
2022-07-23,16,10277,4418,4575,1296,271,100,20937
2022-07-23,17,10296,4715,5046,1112,218,99,21486
2022-07-23,18,10312,5053,4915,1075,125,88,21568
2022-07-23,19,10319,4382,4755,1268,35,109,20868
2022-07-23,20,10322,3776,4630,1462,6,89,20285
2022-07-23,21,10324,4168,4265,1496,0,77,20330
2022-07-23,22,10327,3114,4037,1852,0,78,19408
2022-07-23,23,10322,2256,3605,1981,0,75,18239
2022-07-23,24,10319,1239,3443,1976,0,75,17052
2022-07-24,1,10326,581,3174,2308,0,66,16455
2022-07-24,2,10327,487,3526,1918,0,25,16283
2022-07-24,3,10319,512,3294,2219,0,11,16355
2022-07-24,4,10324,468,3166,2476,0,11,16445
2022-07-24,5,10325,469,3126,2526,1,12,16459
2022-07-24,6,10329,479,2979,2668,2,12,16469
2022-07-24,7,10330,649,3747,1642,16,21,16405
2022-07-24,8,10331,1100,3995,1299,74,29,16828
2022-07-24,9,10333,1240,3831,1358,109,24,16895
2022-07-24,10,10330,1580,3934,1576,147,40,17607
2022-07-24,11,10323,1882,3554,1811,198,72,17840
2022-07-24,12,10323,1971,3550,2131,206,76,18257
2022-07-24,13,10306,2083,3582,2332,158,75,18536
2022-07-24,14,10297,2217,3494,2782,249,75,19114
2022-07-24,15,10311,2207,3584,2861,182,75,19220
2022-07-24,16,10326,2235,3674,3482,172,75,19964
2022-07-24,17,10318,2253,4173,3576,170,75,20565
2022-07-24,18,10320,2592,4383,3229,89,80,20693
2022-07-24,19,10313,2811,4396,2935,24,88,20567
2022-07-24,20,10312,2290,4112,3119,2,81,19916
2022-07-24,21,10318,2072,3999,3006,0,81,19476
2022-07-24,22,10323,1564,3692,2888,0,76,18543
2022-07-24,23,10322,846,3720,2425,0,71,17384
2022-07-24,24,10346,839,3914,1926,0,34,17059
2022-07-25,1,10315,917,3911,1552,0,14,16709
2022-07-25,2,10302,687,3558,1451,0,11,16009
2022-07-25,3,10301,489,2994,1242,0,11,15037
2022-07-25,4,10294,477,3239,1490,0,11,15511
2022-07-25,5,10291,604,3010,1434,2,11,15352
2022-07-25,6,10287,864,3166,1531,3,14,15865
2022-07-25,7,10282,1339,3620,1572,36,37,16886
2022-07-25,8,10278,1852,3908,1623,143,74,17878
2022-07-25,9,10274,2129,3553,1608,249,78,17891
2022-07-25,10,10275,2249,3471,1220,325,77,17617
2022-07-25,11,10280,2314,3449,1201,378,77,17699
2022-07-25,12,10286,2403,3458,1252,388,75,17862
2022-07-25,13,10291,2425,3474,1101,364,76,17731
2022-07-25,14,10298,2104,3640,1230,330,76,17678
2022-07-25,15,10301,1945,3759,1289,327,76,17697
2022-07-25,16,10297,2075,3915,1026,304,76,17693
2022-07-25,17,10329,2373,4274,987,222,76,18261
2022-07-25,18,10349,2495,4619,870,119,75,18527
2022-07-25,19,10357,2760,4705,728,32,76,18658
2022-07-25,20,10359,2838,4635,547,6,85,18470
2022-07-25,21,10365,2489,4602,469,0,94,18019
2022-07-25,22,10354,2086,4391,389,0,84,17304
2022-07-25,23,10376,1269,3813,370,0,73,15901
2022-07-25,24,10383,783,3907,380,0,33,15486
2022-07-26,1,10380,560,3910,353,0,13,15216
2022-07-26,2,10378,477,3933,357,0,11,15156
2022-07-26,3,10382,513,3993,353,0,11,15252
2022-07-26,4,10381,524,3939,331,0,11,15186
2022-07-26,5,10383,561,3686,319,2,11,14962
2022-07-26,6,10382,966,3315,281,6,17,14967
2022-07-26,7,10383,1538,3339,120,44,42,15466
2022-07-26,8,10377,1843,3714,155,142,70,16301
2022-07-26,9,10379,2000,3590,85,227,73,16354
2022-07-26,10,10379,2230,3649,98,290,73,16719
2022-07-26,11,10382,2398,3737,151,319,73,17060
2022-07-26,12,10382,2487,3769,267,354,73,17332
2022-07-26,13,10376,2616,3723,395,331,65,17506
2022-07-26,14,10378,2672,3809,478,350,49,17736
2022-07-26,15,10366,2792,4096,541,303,77,18175
2022-07-26,16,10362,2874,4276,602,300,69,18483
2022-07-26,17,10359,3364,4557,475,234,107,19096
2022-07-26,18,10373,3564,4853,350,127,88,19355
2022-07-26,19,10392,3766,4833,278,36,110,19415
2022-07-26,20,10386,3214,4792,270,6,73,18741
2022-07-26,21,10375,3154,4528,272,0,98,18427
2022-07-26,22,10366,2609,4428,277,0,87,17767
2022-07-26,23,10366,1814,4145,324,0,32,16681
2022-07-26,24,10370,839,3779,352,0,24,15364
2022-07-27,1,10369,473,3820,412,0,15,15089
2022-07-27,2,10376,555,3653,518,0,11,15113
2022-07-27,3,10376,484,3551,607,0,12,15030
2022-07-27,4,10367,506,3544,613,0,14,15044
2022-07-27,5,10377,498,3525,525,2,28,14955
2022-07-27,6,10382,666,3837,481,8,59,15433
2022-07-27,7,10382,1241,3656,472,49,68,15868
2022-07-27,8,10389,1823,3714,239,126,73,16364
2022-07-27,9,10385,2151,3890,416,190,75,17107
2022-07-27,10,10371,2426,3756,459,230,75,17317
2022-07-27,11,10356,2853,3795,240,279,74,17597
2022-07-27,12,10347,3204,4017,565,255,74,18462
2022-07-27,13,10348,3398,4231,649,276,70,18972
2022-07-27,14,10342,3782,4233,597,266,73,19293
2022-07-27,15,10341,3860,4315,677,279,60,19532
2022-07-27,16,10334,4175,4408,544,249,95,19805
2022-07-27,17,10337,4046,4636,519,147,92,19777
2022-07-27,18,10345,3971,4770,590,78,107,19861
2022-07-27,19,10349,3920,4758,589,28,78,19722
2022-07-27,20,10347,3919,4781,485,4,80,19616
2022-07-27,21,10343,3675,4556,623,0,73,19270
2022-07-27,22,10329,2693,4439,705,0,73,18239
2022-07-27,23,10326,1814,4194,722,0,30,17086
2022-07-27,24,10330,850,4200,749,0,23,16152
2022-07-28,1,10332,704,4199,684,0,12,15931
2022-07-28,2,10330,567,4126,592,0,10,15625
2022-07-28,3,10342,696,3842,550,0,11,15441
2022-07-28,4,10355,1031,3911,366,0,11,15674
2022-07-28,5,10358,1253,3736,332,2,10,15691
2022-07-28,6,10357,1834,3189,369,5,11,15765
2022-07-28,7,10354,1986,3569,333,28,20,16290
2022-07-28,8,10347,2312,3884,388,86,40,17057
2022-07-28,9,10318,2665,4042,748,195,71,18039
2022-07-28,10,10290,3073,4146,1335,209,76,19129
2022-07-28,11,10294,3975,4061,1409,208,76,20023
2022-07-28,12,10324,3728,4070,1940,221,76,20359
2022-07-28,13,10320,3128,3816,2456,271,76,20067
2022-07-28,14,10319,3141,4020,2587,239,75,20381
2022-07-28,15,10314,3408,4358,2626,193,76,20975
2022-07-28,16,10319,4097,4549,2360,188,76,21589
2022-07-28,17,10312,3659,4820,2285,151,77,21304
2022-07-28,18,10293,3716,4814,2241,103,76,21243
2022-07-28,19,10296,3971,4842,1969,27,105,21210
2022-07-28,20,10311,3920,4506,1528,6,114,20385
2022-07-28,21,10317,3293,4392,1560,0,95,19657
2022-07-28,22,10332,2448,4002,1542,0,77,18401
2022-07-28,23,10340,1561,3884,1335,0,76,17196
2022-07-28,24,10351,681,4064,1171,0,73,16340
2022-07-29,1,10360,507,3944,1144,0,22,15977
2022-07-29,2,10370,501,3668,991,0,12,15542
2022-07-29,3,10369,514,3675,1009,0,11,15578
2022-07-29,4,10375,625,3572,971,0,11,15554
2022-07-29,5,10375,891,3488,853,1,11,15619
2022-07-29,6,10376,1434,3308,740,3,12,15873
2022-07-29,7,10369,1676,3820,441,38,16,16360
2022-07-29,8,10361,1729,4172,624,143,24,17053
2022-07-29,9,10360,2243,4201,648,255,24,17731
2022-07-29,10,10357,2100,4253,761,342,24,17837
2022-07-29,11,10350,2462,4344,1025,345,24,18550
2022-07-29,12,10339,2382,4186,1332,320,24,18583
2022-07-29,13,10330,2446,3983,1509,315,25,18608
2022-07-29,14,10329,2588,3922,1574,346,25,18784
2022-07-29,15,10331,2774,4104,1625,336,29,19199
2022-07-29,16,10321,2689,4323,1717,299,60,19409
2022-07-29,17,10318,3249,4962,1606,204,74,20413
2022-07-29,18,10317,3195,5031,1413,92,73,20121
2022-07-29,19,10324,2954,4761,1259,28,73,19399
2022-07-29,20,10330,2937,4573,1141,5,75,19061
2022-07-29,21,10344,2880,4643,1145,0,81,19093
2022-07-29,22,10344,2047,4085,1234,0,74,17784
2022-07-29,23,10353,937,3877,1226,0,33,16426
2022-07-29,24,10348,259,3965,1195,0,24,15791
2022-07-30,1,10346,157,3898,1088,0,14,15503
2022-07-30,2,10350,147,4012,1053,0,11,15573
2022-07-30,3,10354,180,4218,832,0,11,15595
2022-07-30,4,10361,184,4037,754,0,11,15347
2022-07-30,5,10365,148,4108,753,2,11,15387
2022-07-30,6,10367,153,4048,778,3,11,15360
2022-07-30,7,10368,165,3974,679,39,19,15244
2022-07-30,8,10372,310,4301,573,144,24,15724
2022-07-30,9,10380,703,4248,588,244,24,16187
2022-07-30,10,10380,977,4498,667,300,24,16846
2022-07-30,11,10387,1434,4401,603,320,24,17169
2022-07-30,12,10387,1820,4212,556,320,24,17319
2022-07-30,13,10391,2276,4316,457,312,24,17776
2022-07-30,14,10375,2408,4222,346,261,24,17636
2022-07-30,15,10368,2582,4131,534,286,24,17925
2022-07-30,16,10371,2711,4689,588,272,24,18655
2022-07-30,17,10381,3376,4835,621,200,23,19436
2022-07-30,18,10377,3731,4770,571,111,24,19584
2022-07-30,19,10376,3972,4616,476,28,24,19492
2022-07-30,20,10368,3490,4535,458,4,24,18879
2022-07-30,21,10375,2879,4318,613,0,24,18209
2022-07-30,22,10375,1923,4023,771,0,24,17116
2022-07-30,23,10378,546,3961,915,0,24,15824
2022-07-30,24,10375,199,3682,1123,0,24,15403
2022-07-31,1,10372,173,3414,1189,0,15,15163
2022-07-31,2,10372,174,3451,1234,0,11,15242
2022-07-31,3,10370,173,3831,1215,0,11,15600
2022-07-31,4,10374,173,4186,1028,0,11,15772
2022-07-31,5,10370,186,4313,900,1,11,15781
2022-07-31,6,10368,212,4200,698,3,11,15492
2022-07-31,7,10363,348,4144,461,46,19,15381
2022-07-31,8,10361,755,4130,180,134,24,15584
2022-07-31,9,10359,1240,3864,141,218,24,15846
2022-07-31,10,10359,1588,3897,118,329,24,16315
2022-07-31,11,10368,2092,4054,162,320,24,17020
2022-07-31,12,10365,2478,4356,260,330,26,17815
2022-07-31,13,10358,2703,4343,390,336,24,18154
2022-07-31,14,10344,2784,4398,601,352,23,18502
2022-07-31,15,10328,2872,4657,664,357,28,18906
2022-07-31,16,10322,3179,4896,744,280,32,19453
2022-07-31,17,10315,3860,5087,687,182,56,20187
2022-07-31,18,10320,4045,4922,648,118,75,20128
2022-07-31,19,10325,4181,4755,573,38,89,19961
2022-07-31,20,10324,3575,4655,623,5,75,19257
2022-07-31,21,10332,2997,4491,902,0,75,18797
2022-07-31,22,10345,2148,4068,1265,0,75,17901
2022-07-31,23,10342,871,3674,1435,0,34,16356
2022-07-31,24,10343,237,3639,1543,0,15,15777
2022-08-01,1,10345,172,3558,1596,0,11,15682
2022-08-01,2,10354,172,3493,1722,0,11,15752
2022-08-01,3,10360,172,3566,1884,0,11,15993
2022-08-01,4,10347,173,3852,1932,0,11,16315
2022-08-01,5,10336,186,4194,1845,1,11,16573
2022-08-01,6,10332,286,3774,1788,4,12,16196
2022-08-01,7,10330,487,3877,1565,35,12,16306
2022-08-01,8,10333,712,4277,1366,127,18,16833
2022-08-01,9,10328,1290,4593,1481,208,24,17924
2022-08-01,10,10327,1795,4492,1828,291,24,18757
2022-08-01,11,10327,2146,3833,2319,326,24,18975
2022-08-01,12,10320,2443,3820,2937,326,24,19870
2022-08-01,13,10313,2545,3834,2962,319,23,19996
2022-08-01,14,10308,2388,4083,3269,337,25,20410
2022-08-01,15,10297,2380,4490,3142,318,24,20651
2022-08-01,16,10284,2530,4698,2853,233,24,20622
2022-08-01,17,10279,2791,5198,2624,170,24,21086
2022-08-01,18,10286,2942,5076,2298,70,23,20695
2022-08-01,19,10295,3084,4806,1871,23,24,20103
2022-08-01,20,10306,3088,4797,1983,2,23,20199
2022-08-01,21,10303,2568,4505,2394,0,23,19793
2022-08-01,22,10306,1954,4364,2351,0,23,18998
2022-08-01,23,10266,1008,4085,2270,0,23,17652
2022-08-01,24,10214,289,4432,1972,0,13,16920
2022-08-02,1,10210,173,4286,1927,0,11,16607
2022-08-02,2,10215,181,4288,1690,0,11,16385
2022-08-02,3,10207,244,4356,1363,0,11,16181
2022-08-02,4,10211,255,4491,1283,0,11,16251
2022-08-02,5,10223,266,4013,1235,1,13,15751
2022-08-02,6,10246,601,3918,1110,3,11,15889
2022-08-02,7,10249,1294,4237,899,38,21,16738
2022-08-02,8,10250,2128,4406,773,112,47,17716
2022-08-02,9,10254,2366,4407,839,176,41,18083
2022-08-02,10,10266,3427,4507,653,245,34,19132
2022-08-02,11,10263,3690,4522,617,278,33,19403
2022-08-02,12,10263,3825,4717,732,257,29,19823
2022-08-02,13,10264,3910,4774,725,307,25,20005
2022-08-02,14,10307,3901,4885,591,289,42,20015
2022-08-02,15,10345,3954,5012,617,304,79,20311
2022-08-02,16,10349,4193,5159,509,260,106,20576
2022-08-02,17,10348,4737,5258,378,195,130,21046
2022-08-02,18,10353,4876,5211,258,114,155,20967
2022-08-02,19,10352,4645,4845,184,30,150,20206
2022-08-02,20,10350,4311,4790,228,4,102,19785
2022-08-02,21,10342,3921,4610,352,0,81,19306
2022-08-02,22,10342,3417,4430,459,0,73,18721
2022-08-02,23,10344,1971,3929,603,0,35,16882
2022-08-02,24,10337,1236,3830,751,0,15,16169
2022-08-03,1,10348,532,3620,1075,0,11,15586
2022-08-03,2,10339,208,3456,1295,0,12,15310
2022-08-03,3,10341,182,3406,1613,0,11,15553
2022-08-03,4,10340,179,3379,1943,0,11,15852
2022-08-03,5,10332,311,3478,1820,2,11,15954
2022-08-03,6,10325,638,3403,1598,3,11,15978
2022-08-03,7,10318,1330,3655,1397,44,11,16755
2022-08-03,8,10310,1923,3825,1093,122,20,17293
2022-08-03,9,10304,2523,3709,1320,186,24,18066
2022-08-03,10,10303,2634,3697,1386,251,28,18299
2022-08-03,11,10304,3003,3791,1006,294,33,18431
2022-08-03,12,10298,3203,3746,1866,328,29,19470
2022-08-03,13,10298,3351,3820,2415,376,46,20306
2022-08-03,14,10298,3373,4144,2283,299,77,20474
2022-08-03,15,10315,3646,4590,2353,219,83,21206
2022-08-03,16,10325,4322,4923,2069,205,91,21935
2022-08-03,17,10317,3982,4908,1974,153,97,21431
2022-08-03,18,10307,3789,4944,1674,50,98,20862
2022-08-03,19,10309,3543,4557,1992,17,55,20473
2022-08-03,20,10299,3618,4728,1840,0,36,20521
2022-08-03,21,10280,3666,4890,1529,0,24,20389
2022-08-03,22,10267,3260,4546,1445,0,24,19542
2022-08-03,23,10260,1721,4442,1577,0,24,18024
2022-08-03,24,10260,575,3844,2012,0,13,16704
2022-08-04,1,10259,363,3801,1965,0,11,16399
2022-08-04,2,10260,200,4098,1825,0,11,16394
2022-08-04,3,10260,182,4379,1561,0,11,16393
2022-08-04,4,10265,271,4392,1366,0,11,16305
2022-08-04,5,10273,385,4267,1214,1,11,16151
2022-08-04,6,10280,1235,4306,794,2,11,16628
2022-08-04,7,10283,2222,3814,478,3,11,16811
2022-08-04,8,10282,2228,3814,473,3,11,16811
2022-08-04,9,10282,2228,3814,473,3,11,16811
2022-08-04,10,10282,2228,3814,473,3,11,16811
2022-08-04,11,10282,2228,3814,473,3,11,16811
2022-08-04,12,10282,2228,3814,473,3,11,16811
2022-08-04,13,10282,2228,3814,473,3,11,16811
2022-08-04,14,10314,4806,4846,550,220,74,20810
2022-08-04,15,10322,4811,5041,626,250,75,21125
2022-08-04,16,10321,4849,5129,551,185,73,21108
2022-08-04,17,10319,5122,5140,400,150,85,21216
2022-08-04,18,10312,5240,5156,400,77,108,21293
2022-08-04,19,10299,4724,4876,383,24,83,20389
2022-08-04,20,10288,4690,4773,387,2,85,20225
2022-08-04,21,10277,4912,4663,311,0,106,20269
2022-08-04,22,10287,4401,4424,307,0,86,19505
2022-08-04,23,10291,3705,4269,300,0,35,18600
2022-08-04,24,10294,2483,4177,288,0,13,17255
2022-08-05,1,10302,1409,4223,252,0,12,16198
2022-08-05,2,10315,949,4188,236,0,11,15699
2022-08-05,3,10321,1211,3933,315,0,11,15791
2022-08-05,4,10321,1545,3752,445,0,11,16074
2022-08-05,5,10321,2056,3527,452,1,11,16368
2022-08-05,6,10312,2420,3387,461,3,11,16594
2022-08-05,7,10308,2652,3574,260,24,11,16829
2022-08-05,8,10304,2910,4150,231,104,17,17716
2022-08-05,9,10311,3758,4360,96,210,23,18758
2022-08-05,10,10305,4250,4583,83,227,24,19472
2022-08-05,11,10286,4625,4652,135,254,24,19976
2022-08-05,12,10260,4879,4718,204,281,32,20374
2022-08-05,13,10249,4878,4617,264,354,56,20418
2022-08-05,14,10245,5100,4639,262,289,81,20616
2022-08-05,15,10231,4838,4794,253,273,94,20483
2022-08-05,16,10219,5028,4957,173,206,109,20692
2022-08-05,17,10220,4649,5138,175,131,115,20428
2022-08-05,18,10234,4580,5124,280,101,114,20433
2022-08-05,19,10241,4795,4863,413,27,119,20458
2022-08-05,20,10243,4714,4810,400,2,118,20287
2022-08-05,21,10218,4742,4550,508,0,111,20129
2022-08-05,22,10253,3632,4514,628,0,81,19108
2022-08-05,23,10270,2799,4375,623,0,42,18109
2022-08-05,24,10281,1664,4279,693,0,21,16938
2022-08-06,1,10295,682,4059,705,0,19,15760
2022-08-06,2,10300,252,3965,729,0,19,15265
2022-08-06,3,10293,178,3702,773,0,19,14965
2022-08-06,4,10285,180,3794,730,0,19,15008
2022-08-06,5,10275,432,3895,721,0,20,15343
2022-08-06,6,10273,925,3134,696,2,20,15050
2022-08-06,7,10260,1803,3332,629,28,20,16072
2022-08-06,8,10248,2362,3765,538,119,30,17062
2022-08-06,9,10237,2684,4544,415,209,34,18123
2022-08-06,10,10224,3592,4547,392,297,36,19088
2022-08-06,11,10226,4266,4867,525,355,31,20270
2022-08-06,12,10208,4322,4736,735,365,40,20406
2022-08-06,13,10194,4238,4848,941,379,67,20667
2022-08-06,14,10193,4503,4880,1003,367,98,21044
2022-08-06,15,10191,4593,4984,994,351,110,21223
2022-08-06,16,10184,4600,4985,1050,297,97,21213
2022-08-06,17,10180,4636,5181,909,201,89,21196
2022-08-06,18,10180,4880,5198,726,97,50,21131
2022-08-06,19,10178,5200,5137,573,25,42,21155
2022-08-06,20,10175,5045,4765,665,2,41,20693
2022-08-06,21,10168,4882,4708,892,0,37,20687
2022-08-06,22,10166,4412,4587,1197,0,32,20394
2022-08-06,23,10166,3108,4359,1254,0,32,18919
2022-08-06,24,10171,2563,3909,1352,0,22,18017
2022-08-07,1,10176,1713,3737,1479,0,20,17125
2022-08-07,2,10173,1212,3566,1565,0,21,16537
2022-08-07,3,10170,749,3608,1427,0,21,15975
2022-08-07,4,10169,727,3499,1295,0,21,15711
2022-08-07,5,10175,1007,3630,1075,2,21,15910
2022-08-07,6,10179,1323,3364,917,4,21,15808
2022-08-07,7,10185,1916,3206,768,27,22,16124
2022-08-07,8,10191,2535,3886,634,103,28,17377
2022-08-07,9,10199,3517,3997,720,174,42,18649
2022-08-07,10,10200,3757,4285,998,206,72,19518
2022-08-07,11,10207,4188,4552,1235,202,75,20459
2022-08-07,12,10204,3964,4607,1483,267,71,20596
2022-08-07,13,10203,4087,4646,1673,289,78,20976
2022-08-07,14,10200,3692,4641,1939,319,87,20878
2022-08-07,15,10177,3811,4864,2005,326,93,21276
2022-08-07,16,10170,4249,5157,1701,273,93,21643
2022-08-07,17,10164,4566,5182,1506,168,89,21675
2022-08-07,18,10161,4191,5281,1300,72,91,21096
2022-08-07,19,10159,4604,5344,868,28,90,21093
2022-08-07,20,10158,5016,5195,739,6,108,21222
2022-08-07,21,10159,5138,4783,653,6,94,20833
2022-08-07,22,10173,4902,4638,820,6,78,20617
2022-08-07,23,10188,4117,4131,798,6,35,19275
2022-08-07,24,10187,3313,3966,817,6,15,18304
2022-08-08,1,10199,2506,3893,865,6,11,17480
2022-08-08,2,10203,2003,3729,818,6,11,16770
2022-08-08,3,10204,1804,3680,827,6,11,16532
2022-08-08,4,10203,1838,3421,1136,6,11,16615
2022-08-08,5,10211,2317,3323,982,7,11,16851
2022-08-08,6,10213,2873,3447,1024,1,11,17569
2022-08-08,7,10214,3138,4092,1028,6,11,18489
2022-08-08,8,10213,3913,4095,1171,35,41,19468
2022-08-08,9,10215,3971,4110,1317,76,73,19762
2022-08-08,10,10217,4683,4379,1230,117,75,20701
2022-08-08,11,10214,4754,4397,1365,144,76,20950
2022-08-08,12,10213,4617,4296,2018,235,75,21454
2022-08-08,13,10200,4257,4227,2506,193,76,21459
2022-08-08,14,10190,4443,4448,2701,166,75,22023
2022-08-08,15,10189,4912,4698,2717,198,77,22791
2022-08-08,16,10202,4606,4684,2488,181,83,22244
2022-08-08,17,10194,4739,4659,2321,110,85,22108
2022-08-08,18,10192,4759,4911,1882,56,84,21884
2022-08-08,19,10211,4651,4683,2091,30,80,21746
2022-08-08,20,10221,3791,4666,2172,24,75,20949
2022-08-08,21,10216,4160,4383,1857,24,75,20715
2022-08-08,22,10207,3342,4231,1957,24,75,19836
2022-08-08,23,10214,2043,4002,1810,24,36,18129
2022-08-08,24,10204,814,3961,1656,24,13,16672
2022-08-09,1,10219,686,3810,1366,24,12,16117
2022-08-09,2,10234,506,3787,1315,24,12,15878
2022-08-09,3,10254,528,3840,1148,24,12,15806
2022-08-09,4,10283,828,3575,994,24,11,15715
2022-08-09,5,10302,1337,3402,812,25,12,15890
2022-08-09,6,10312,1699,3327,665,26,11,16040
2022-08-09,7,10322,1795,3530,455,47,11,16160
2022-08-09,8,10328,2093,4093,402,99,19,17034
2022-08-09,9,10327,2514,3929,482,162,24,17438
2022-08-09,10,10332,2711,4136,495,185,24,17883
2022-08-09,11,10350,2996,4044,482,224,24,18120
2022-08-09,12,10337,3171,4071,465,243,24,18311
2022-08-09,13,10344,3296,4249,477,259,24,18649
2022-08-09,14,10344,3327,4267,459,271,24,18692
2022-08-09,15,10344,3559,4073,456,263,24,18719
2022-08-09,16,10335,3564,4442,426,225,25,19017
2022-08-09,17,10322,3738,4716,398,156,32,19362
2022-08-09,18,10325,3670,4810,399,89,59,19352
2022-08-09,19,10343,3607,4692,324,43,74,19083
2022-08-09,20,10347,3534,4683,243,7,73,18887
2022-08-09,21,10366,3443,4429,243,1,73,18555
2022-08-09,22,10374,2458,4269,260,0,76,17437
2022-08-09,23,10385,1294,4087,236,0,33,16035
2022-08-09,24,10400,484,3848,198,0,14,14944
2022-08-10,1,10412,239,3797,192,0,11,14651
2022-08-10,2,10429,281,3763,169,0,12,14654
2022-08-10,3,10428,306,3705,219,0,11,14669
2022-08-10,4,10412,407,3668,260,0,11,14758
2022-08-10,5,10397,703,3320,260,0,11,14691
2022-08-10,6,10377,1117,3575,208,8,13,15298
2022-08-10,7,10374,1449,3630,162,58,11,15684
2022-08-10,8,10373,1685,4060,121,155,18,16412
2022-08-10,9,10359,2100,4135,120,279,23,17016
2022-08-10,10,10359,2319,4130,218,343,23,17392
2022-08-10,11,10352,2700,4299,254,337,27,17969
2022-08-10,12,10341,2916,4270,304,367,30,18228
2022-08-10,13,10321,2994,4277,354,381,39,18366
2022-08-10,14,10319,3227,4445,412,371,49,18823
2022-08-10,15,10302,3349,4682,460,382,81,19256
2022-08-10,16,10301,4019,4886,541,320,95,20162
2022-08-10,17,10286,4824,4874,586,229,128,20927
2022-08-10,18,10281,4862,4794,642,120,129,20828
2022-08-10,19,10289,4469,4643,754,25,97,20277
2022-08-10,20,10314,3661,4596,931,3,96,19601
2022-08-10,21,10348,3202,4510,1033,0,90,19183
2022-08-10,22,10351,2719,4049,1187,0,81,18387
2022-08-10,23,10318,1651,3677,1242,0,76,16964
2022-08-10,24,10292,1010,3271,1375,0,22,15970
2022-08-11,1,10295,567,3373,1609,0,12,15856
2022-08-11,2,10287,256,2833,1801,0,11,15188
2022-08-11,3,10285,416,2810,1648,0,11,15170
2022-08-11,4,10293,566,2885,1572,0,11,15327
2022-08-11,5,10324,584,2908,1410,1,13,15240
2022-08-11,6,10371,640,3073,1301,2,13,15400
2022-08-11,7,10393,764,3503,918,25,17,15620
2022-08-11,8,10408,1093,3884,1075,107,28,16595
2022-08-11,9,10414,1241,3878,1009,211,30,16783
2022-08-11,10,10437,1738,3871,726,325,40,17137
2022-08-11,11,10445,1909,3928,879,340,33,17534
2022-08-11,12,10450,2179,3767,1012,308,26,17742
2022-08-11,13,10444,2224,3692,1116,309,27,17812
2022-08-11,14,10447,2264,3796,1062,341,27,17937
2022-08-11,15,10448,2528,3847,1048,351,34,18256
2022-08-11,16,10433,2310,4037,1654,333,59,18826
2022-08-11,17,10416,2561,4085,1909,229,78,19278
2022-08-11,18,10393,2346,4163,1813,117,79,18911
2022-08-11,19,10365,2245,3952,1893,29,79,18563
2022-08-11,20,10354,2047,3709,1685,1,78,17874
2022-08-11,21,10350,1194,3888,1772,0,77,17281
2022-08-11,22,10349,941,3798,1675,0,78,16841
2022-08-11,23,10353,307,3408,1718,0,75,15861
2022-08-11,24,10366,148,3342,1515,0,20,15391
2022-08-12,1,10403,145,3260,1365,0,17,15190
2022-08-12,2,10460,146,3571,1120,0,17,15314
2022-08-12,3,10477,146,3445,996,0,17,15081
2022-08-12,4,10483,144,3619,852,0,17,15115
2022-08-12,5,10482,149,3268,716,2,17,14634
2022-08-12,6,10481,258,2991,678,2,16,14426
2022-08-12,7,10479,411,3049,527,32,16,14514
2022-08-12,8,10469,764,3975,309,126,24,15667
2022-08-12,9,10465,1297,4040,103,228,29,16162
2022-08-12,10,10455,1312,4010,75,302,29,16183
2022-08-12,11,10443,1471,4232,90,335,28,16599
2022-08-12,12,10434,1590,4106,194,338,27,16689
2022-08-12,13,10400,1674,3915,365,343,28,16725
2022-08-12,14,10387,1750,3921,519,340,28,16945
2022-08-12,15,10372,1689,3998,512,327,45,16943
2022-08-12,16,10375,2259,4279,454,281,84,17732
2022-08-12,17,10378,2624,4352,435,212,105,18106
2022-08-12,18,10396,2800,4521,305,108,101,18231
2022-08-12,19,10415,2880,4392,226,21,127,18061
2022-08-12,20,10424,2733,4229,211,1,126,17724
2022-08-12,21,10435,2251,4151,200,0,83,17120
2022-08-12,22,10437,1535,3860,225,0,75,16132
2022-08-12,23,10441,877,3369,181,0,75,14943
2022-08-12,24,10442,296,3507,310,0,26,14581
2022-08-13,1,10447,192,3580,289,0,16,14524
2022-08-13,2,10430,214,3671,238,0,15,14568
2022-08-13,3,10412,187,3444,216,0,15,14274
2022-08-13,4,10389,157,3496,162,0,15,14219
2022-08-13,5,10383,144,3455,107,1,15,14105
2022-08-13,6,10381,139,3394,98,2,15,14029
2022-08-13,7,10384,139,3279,62,37,15,13916
2022-08-13,8,10402,141,3462,34,133,22,14194
2022-08-13,9,10410,162,3646,8,237,27,14490
2022-08-13,10,10412,268,3919,11,300,27,14937
2022-08-13,11,10409,491,4065,37,336,27,15365
2022-08-13,12,10395,833,3994,51,333,27,15633
2022-08-13,13,10376,945,4024,71,323,27,15766
2022-08-13,14,10357,1235,3985,138,307,46,16068
2022-08-13,15,10343,1525,4156,144,276,79,16523
2022-08-13,16,10368,1772,3901,159,246,79,16525
2022-08-13,17,10369,2064,4299,124,152,87,17095
2022-08-13,18,10371,2311,4119,89,53,96,17039
2022-08-13,19,10366,1995,4144,69,13,81,16668
2022-08-13,20,10361,1463,4231,59,2,97,16213
2022-08-13,21,10363,1164,4229,44,0,118,15918
2022-08-13,22,10376,767,4087,36,0,127,15393
2022-08-13,23,10387,277,3709,44,0,64,14481
2022-08-13,24,10395,169,3569,71,0,49,14253
2022-08-14,1,10399,141,3396,111,0,46,14093
2022-08-14,2,10398,142,3442,149,0,49,14180
2022-08-14,3,10396,196,3632,121,0,40,14385
2022-08-14,4,10389,240,3507,155,0,36,14327
2022-08-14,5,10387,149,3201,195,1,44,13977
2022-08-14,6,10376,140,2936,203,3,35,13693
2022-08-14,7,10379,145,3109,279,39,31,13982
2022-08-14,8,10386,158,3042,262,89,33,13970
2022-08-14,9,10385,284,3497,145,169,32,14512
2022-08-14,10,10395,635,3828,104,254,27,15243
2022-08-14,11,10398,1373,3749,103,251,30,15904
2022-08-14,12,10389,1567,3603,90,291,33,15973
2022-08-14,13,10352,1634,3877,79,220,28,16190
2022-08-14,14,10353,1787,3890,74,195,27,16326
2022-08-14,15,10357,1764,3903,141,173,29,16367
2022-08-14,16,10349,1892,4052,176,206,31,16706
2022-08-14,17,10348,2140,4330,158,147,49,17172
2022-08-14,18,10339,2334,4287,114,74,78,17226
2022-08-14,19,10331,2270,4158,117,28,78,16982
2022-08-14,20,10321,1978,4194,141,14,78,16726
2022-08-14,21,10303,1729,4176,169,12,78,16467
2022-08-14,22,10302,1059,3992,210,12,67,15642
2022-08-14,23,10294,768,3793,255,12,27,15149
2022-08-14,24,10316,426,3510,399,12,18,14681
2022-08-15,1,10328,324,3504,481,8,14,14659
2022-08-15,2,10343,169,3504,479,0,15,14510
2022-08-15,3,10339,200,3510,455,0,15,14519
2022-08-15,4,10341,319,3239,560,0,14,14473
2022-08-15,5,10339,463,3295,763,1,17,14878
2022-08-15,6,10333,816,2742,994,2,16,14903
2022-08-15,7,10324,1635,2970,338,38,15,15320
2022-08-15,8,10306,1776,3227,464,126,24,15923
2022-08-15,9,10295,1899,3485,487,204,28,16398
2022-08-15,10,10311,2180,3520,535,292,27,16865
2022-08-15,11,10305,2442,3593,634,350,27,17351
2022-08-15,12,10303,2513,3788,704,373,30,17711
2022-08-15,13,10269,2846,3859,708,362,37,18081
2022-08-15,14,10254,3387,3992,660,294,64,18651
2022-08-15,15,10251,3852,3930,606,318,100,19057
2022-08-15,16,10245,4169,3966,609,307,107,19403
2022-08-15,17,10251,4080,4298,652,171,136,19588
2022-08-15,18,10260,4025,4287,586,85,153,19396
2022-08-15,19,10268,3762,4191,664,33,152,19070
2022-08-15,20,10276,3402,4073,774,5,130,18660
2022-08-15,21,10282,3425,3739,906,1,166,18519
2022-08-15,22,10284,2530,3475,1028,0,102,17419
2022-08-15,23,10292,1496,3526,963,0,47,16324
2022-08-15,24,10294,802,3384,990,0,33,15503
2022-08-16,1,10294,224,3242,1146,0,27,14933
2022-08-16,2,10288,160,3169,1287,0,18,14922
2022-08-16,3,10284,169,3337,1137,0,18,14945
2022-08-16,4,10276,354,3376,1042,0,17,15065
2022-08-16,5,10263,846,2886,823,1,17,14836
2022-08-16,6,10251,1495,2989,897,3,22,15657
2022-08-16,7,10250,1937,2953,629,24,20,15813
2022-08-16,8,10249,2448,3518,573,111,27,16926
2022-08-16,9,10267,3226,3640,265,210,29,17637
2022-08-16,10,10281,3321,3634,269,280,29,17814
2022-08-16,11,10292,3489,3769,196,295,30,18071
2022-08-16,12,10289,3935,4055,188,264,27,18758
2022-08-16,13,10282,3911,3871,251,261,24,18600
2022-08-16,14,10275,4145,3886,417,251,44,19018
2022-08-16,15,10262,3937,3930,602,249,70,19050
2022-08-16,16,10238,4478,4106,537,191,96,19646
2022-08-16,17,10225,4527,4373,520,154,78,19877
2022-08-16,18,10226,4469,4414,395,76,82,19662
2022-08-16,19,10235,3880,4323,496,21,81,19036
2022-08-16,20,10245,3662,4291,506,1,81,18786
2022-08-16,21,10245,3566,4189,472,0,78,18550
2022-08-16,22,10249,3094,3737,459,0,78,17617
2022-08-16,23,10254,2192,3738,300,0,43,16527
2022-08-16,24,10263,1778,3648,253,0,24,15966
2022-08-17,1,10273,1281,3526,270,0,22,15372
2022-08-17,2,10277,673,3280,286,0,27,14543
2022-08-17,3,10280,658,3345,379,0,29,14691
2022-08-17,4,10281,947,3070,380,0,38,14716
2022-08-17,5,10277,1458,3263,322,1,37,15358
2022-08-17,6,10280,1698,3128,322,1,27,15456
2022-08-17,7,10274,2075,3028,185,19,25,15606
2022-08-17,8,10266,2304,3128,131,98,33,15960
2022-08-17,9,10266,2320,3632,70,199,38,16525
2022-08-17,10,10256,2982,3765,39,289,42,17373
2022-08-17,11,10246,3445,4004,42,374,44,18155
2022-08-17,12,10249,3961,3884,83,395,37,18609
2022-08-17,13,10249,3965,3959,165,379,38,18755
2022-08-17,14,10241,3669,4025,269,338,40,18582
2022-08-17,15,10223,3727,4050,327,308,45,18680
2022-08-17,16,10218,4165,4089,381,262,76,19191
2022-08-17,17,10218,4164,4297,350,182,87,19298
2022-08-17,18,10219,4331,4372,175,106,85,19288
2022-08-17,19,10221,4245,4140,126,32,85,18849
2022-08-17,20,10226,4232,4228,114,5,93,18898
2022-08-17,21,10233,3832,3794,92,0,101,18052
2022-08-17,22,10240,2857,3730,106,0,53,16986
2022-08-17,23,10239,1769,3573,49,0,45,15675
2022-08-17,24,10231,1062,3480,10,0,36,14819
2022-08-18,1,10232,742,3399,36,0,28,14437
2022-08-18,2,10225,615,3303,74,0,29,14246
2022-08-18,3,10222,577,3386,99,0,27,14311
2022-08-18,4,10201,740,3340,91,0,25,14397
2022-08-18,5,10205,1090,2948,125,1,28,14397
2022-08-18,6,10195,1596,2955,94,5,32,14877
2022-08-18,7,10196,1883,3045,109,40,32,15305
2022-08-18,8,10196,2211,3117,71,139,34,15768
2022-08-18,9,10198,2556,3379,30,262,38,16463
2022-08-18,10,10203,2720,3889,27,341,34,17214
2022-08-18,11,10205,3308,3931,19,381,34,17878
2022-08-18,12,10219,3732,3981,90,374,34,18430
2022-08-18,13,10224,4027,3964,184,379,43,18821
2022-08-18,14,10209,4269,4056,312,338,75,19259
2022-08-18,15,10180,4440,4041,462,298,88,19509
2022-08-18,16,10166,4619,4062,580,261,92,19780
2022-08-18,17,10166,4635,4698,620,176,96,20391
2022-08-18,18,10151,4650,4693,489,92,90,20165
2022-08-18,19,10132,4515,4601,458,27,91,19824
2022-08-18,20,10142,4109,4599,458,10,135,19453
2022-08-18,21,10154,3768,4369,422,6,149,18868
2022-08-18,22,10169,2848,3948,427,1,99,17492
2022-08-18,23,10175,1562,3847,389,0,83,16056
2022-08-18,24,10205,843,3653,395,0,35,15131
2022-08-19,1,10208,334,3579,469,0,22,14612
2022-08-19,2,10206,181,3573,543,0,22,14525
2022-08-19,3,10215,176,3366,624,0,22,14403
2022-08-19,4,10212,194,3409,612,0,22,14449
2022-08-19,5,10218,337,3334,529,0,22,14440
2022-08-19,6,10213,715,3381,471,1,22,14803
2022-08-19,7,10212,1405,3117,443,36,22,15235
2022-08-19,8,10214,2363,3226,182,128,30,16143
2022-08-19,9,10211,2803,3614,169,255,33,17085
2022-08-19,10,10196,3326,3794,304,342,34,17996
2022-08-19,11,10193,3726,4171,410,373,35,18908
2022-08-19,12,10175,4090,4361,460,291,34,19411
2022-08-19,13,10156,4233,4293,521,295,43,19541
2022-08-19,14,10150,4493,4328,541,311,70,19893
2022-08-19,15,10161,4040,4311,533,346,84,19475
2022-08-19,16,10154,4099,4471,499,298,85,19606
2022-08-19,17,10153,4275,4775,351,156,86,19796
2022-08-19,18,10163,4454,4634,278,79,85,19693
2022-08-19,19,10173,4563,4496,307,17,87,19643
2022-08-19,20,10182,4110,4312,438,0,88,19130
2022-08-19,21,10191,3365,4454,564,0,84,18658
2022-08-19,22,10196,2642,3902,634,0,84,17458
2022-08-19,23,10193,1796,3762,676,0,85,16512
2022-08-19,24,10196,958,3588,744,0,24,15510
2022-08-20,1,10195,560,3180,782,0,12,14729
2022-08-20,2,10185,431,3162,794,0,20,14592
2022-08-20,3,10173,462,3104,744,0,22,14505
2022-08-20,4,10171,534,3161,699,0,22,14587
2022-08-20,5,10189,685,3029,611,0,22,14536
2022-08-20,6,10196,947,2996,548,2,22,14711
2022-08-20,7,10202,1167,2852,573,29,22,14845
2022-08-20,8,10200,1607,3098,313,121,30,15369
2022-08-20,9,10195,2154,3549,270,224,33,16425
2022-08-20,10,10189,2687,3593,301,313,33,17116
2022-08-20,11,10183,3332,3770,357,332,38,18012
2022-08-20,12,10173,3419,4117,365,351,35,18460
2022-08-20,13,10166,3601,4136,450,352,43,18748
2022-08-20,14,10160,3977,4222,460,349,81,19249
2022-08-20,15,10147,4096,4367,516,316,104,19546
2022-08-20,16,10137,4384,4433,485,241,103,19783
2022-08-20,17,10132,4463,4510,299,141,100,19645
2022-08-20,18,10127,3567,4588,430,50,102,18864
2022-08-20,19,10132,3278,4211,721,17,58,18417
2022-08-20,20,10126,3585,4498,482,4,35,18730
2022-08-20,21,10136,4010,4395,387,4,34,18966
2022-08-20,22,10150,3246,4136,397,4,33,17966
2022-08-20,23,10145,2404,3850,204,4,33,16640
2022-08-20,24,10151,1807,3659,181,4,23,15825
